viewer_id,day,battleground_state,minutes_tv_news,total_ads_seen,voting_intent,ads_candidate_A,ads_candidate_B
1,1,0,23,1,68.0,0,1
1,2,0,0,4,66.0,2,2
1,3,0,6,0,68.6,0,0
1,4,0,15,1,72.9,1,0
1,5,0,36,5,67.3,4,1
1,6,0,0,0,72.6,0,0
1,7,0,11,5,70.9,3,2
1,8,0,23,5,71.5,3,2
1,9,0,0,4,70.7,2,2
1,10,0,0,1,69.6,0,1
1,11,0,25,5,68.4,4,1
1,12,0,0,1,72.6,1,0
1,13,0,6,2,71.6,2,0
1,14,0,2,4,68.9,3,1
1,15,0,0,1,68.2,0,1
1,16,0,0,1,73.6,1,0
1,17,0,9,1,70.7,1,0
1,18,0,11,2,71.4,2,0
1,19,0,9,2,70.8,2,0
1,20,0,20,5,70.7,3,2
1,21,0,3,1,70.3,0,1
1,22,0,0,3,73.0,2,1
1,23,0,17,3,70.7,2,1
1,24,0,0,2,74.5,2,0
1,25,0,40,8,70.2,5,3
1,26,0,18,5,73.4,3,2
1,27,0,5,1,72.2,1,0
1,28,0,11,3,70.0,1,2
1,29,0,5,3,72.1,1,2
1,30,0,0,2,71.4,0,2
2,1,0,110,8,77.6,4,4
2,2,0,111,11,79.5,5,6
2,3,0,101,8,80.4,5,3
2,4,0,118,10,76.2,7,3
2,5,0,104,10,79.6,8,2
2,6,0,70,8,77.6,4,4
2,7,0,84,11,79.3,8,3
2,8,0,115,15,79.6,10,5
2,9,0,121,12,72.1,9,3
2,10,0,96,10,77.6,8,2
2,11,0,133,16,79.1,9,7
2,12,0,118,15,76.5,9,6
2,13,0,92,11,76.1,5,6
2,14,0,66,10,74.4,6,4
2,15,0,137,22,70.8,14,8
2,16,0,126,18,77.9,7,11
2,17,0,99,16,79.4,11,5
2,18,0,90,14,76.5,9,5
2,19,0,108,22,76.5,11,11
2,20,0,84,15,80.5,13,2
2,21,0,62,12,77.5,8,4
2,22,0,107,18,77.7,14,4
2,23,0,89,15,77.5,8,7
2,24,0,105,21,78.6,10,11
2,25,0,114,23,80.4,15,8
2,26,0,131,24,76.9,16,8
2,27,0,74,14,79.5,8,6
2,28,0,90,18,78.3,9,9
2,29,0,130,27,77.0,19,8
2,30,0,136,29,78.6,17,12
3,1,0,11,0,25.6,0,0
3,2,0,32,3,26.2,2,1
3,3,0,0,3,29.8,3,0
3,4,0,33,5,27.0,3,2
3,5,0,50,6,26.3,5,1
3,6,0,15,3,27.8,2,1
3,7,0,20,1,26.1,0,1
3,8,0,29,6,26.9,2,4
3,9,0,23,4,29.9,2,2
3,10,0,54,11,26.6,4,7
3,11,0,25,5,30.1,2,3
3,12,0,49,6,26.7,5,1
3,13,0,5,0,25.0,0,0
3,14,0,35,5,27.7,2,3
3,15,0,21,2,23.5,2,0
3,16,0,30,7,26.6,4,3
3,17,0,17,2,29.3,1,1
3,18,0,49,10,23.9,6,4
3,19,0,27,5,28.6,2,3
3,20,0,18,4,25.4,2,2
3,21,0,11,5,27.4,0,5
3,22,0,25,6,27.6,4,2
3,23,0,23,6,25.6,1,5
3,24,0,29,7,27.6,5,2
3,25,0,21,6,27.7,4,2
3,26,0,32,6,31.2,4,2
3,27,0,16,2,27.2,2,0
3,28,0,44,10,31.6,4,6
3,29,0,43,11,22.9,3,8
3,30,0,17,4,28.8,1,3
4,1,1,74,17,58.4,5,12
4,2,1,65,17,60.2,10,7
4,3,1,64,16,63.1,7,9
4,4,1,37,11,54.4,5,6
4,5,1,35,10,61.3,4,6
4,6,1,35,14,62.6,9,5
4,7,1,31,10,58.6,5,5
4,8,1,59,19,57.5,8,11
4,9,1,31,12,56.6,3,9
4,10,1,42,14,56.1,7,7
4,11,1,37,15,60.7,8,7
4,12,1,25,19,61.1,9,10
4,13,1,29,10,58.9,5,5
4,14,1,39,16,59.1,6,10
4,15,1,45,21,62.8,11,10
4,16,1,25,11,62.4,6,5
4,17,1,49,22,58.0,10,12
4,18,1,58,26,56.4,14,12
4,19,1,64,30,58.9,10,20
4,20,1,38,19,59.6,14,5
4,21,1,30,18,61.1,5,13
4,22,1,32,17,59.0,11,6
4,23,1,39,19,59.3,13,6
4,24,1,64,36,59.0,17,19
4,25,1,87,51,55.4,21,30
4,26,1,57,33,59.4,18,15
4,27,1,28,20,57.0,6,14
4,28,1,33,22,57.3,12,10
4,29,1,61,37,58.4,19,18
4,30,1,36,24,59.8,14,10
5,1,1,94,20,22.8,9,11
5,2,1,129,32,17.4,15,17
5,3,1,92,22,24.4,15,7
5,4,1,106,26,17.5,13,13
5,5,1,114,35,22.4,18,17
5,6,1,68,24,20.8,13,11
5,7,1,88,25,17.5,12,13
5,8,1,126,39,21.5,15,24
5,9,1,128,43,20.2,22,21
5,10,1,120,41,25.3,21,20
5,11,1,135,47,26.0,26,21
5,12,1,117,44,23.6,23,21
5,13,1,69,26,23.7,14,12
5,14,1,76,33,24.5,13,20
5,15,1,128,53,31.3,18,35
5,16,1,114,47,21.9,14,33
5,17,1,126,54,21.2,39,15
5,18,1,119,53,21.8,31,22
5,19,1,112,53,18.1,26,27
5,20,1,80,40,19.2,20,20
5,21,1,86,42,20.9,21,21
5,22,1,98,51,22.0,31,20
5,23,1,110,55,19.4,27,28
5,24,1,121,65,20.2,28,37
5,25,1,123,65,23.2,29,36
5,26,1,129,71,17.5,23,48
5,27,1,102,62,19.5,22,40
5,28,1,102,60,26.1,43,17
5,29,1,149,89,21.8,43,46
5,30,1,113,69,22.2,29,40
6,1,0,69,5,63.7,2,3
6,2,0,42,4,65.6,4,0
6,3,0,88,13,64.2,4,9
6,4,0,68,6,63.6,4,2
6,5,0,83,9,61.2,6,3
6,6,0,54,5,63.6,4,1
6,7,0,51,5,62.9,4,1
6,8,0,54,10,62.6,7,3
6,9,0,42,6,65.0,5,1
6,10,0,46,7,64.2,5,2
6,11,0,72,11,62.8,8,3
6,12,0,90,10,60.3,7,3
6,13,0,25,3,63.4,1,2
6,14,0,39,7,61.4,6,1
6,15,0,47,7,55.2,5,2
6,16,0,83,11,61.8,4,7
6,17,0,65,9,65.9,7,2
6,18,0,47,8,61.0,8,0
6,19,0,70,10,69.3,6,4
6,20,0,59,9,63.9,3,6
6,21,0,57,10,65.9,5,5
6,22,0,53,8,63.5,5,3
6,23,0,48,10,62.5,4,6
6,24,0,51,8,62.3,6,2
6,25,0,81,15,61.0,11,4
6,26,0,24,4,65.3,1,3
6,27,0,40,8,61.9,5,3
6,28,0,42,9,63.1,5,4
6,29,0,68,14,62.4,9,5
6,30,0,83,16,65.3,9,7
7,1,0,67,5,70.3,2,3
7,2,0,107,9,74.3,4,5
7,3,0,66,6,69.2,1,5
7,4,0,67,6,71.5,2,4
7,5,0,54,8,71.9,2,6
7,6,0,56,6,74.1,1,5
7,7,0,54,6,72.8,3,3
7,8,0,100,12,71.2,5,7
7,9,0,81,9,68.1,1,8
7,10,0,65,9,73.3,2,7
7,11,0,79,12,69.3,2,10
7,12,0,95,13,72.6,6,7
7,13,0,62,7,71.2,0,7
7,14,0,57,10,75.4,3,7
7,15,0,75,13,78.1,3,10
7,16,0,77,12,71.2,3,9
7,17,0,80,16,73.1,5,11
7,18,0,52,12,68.9,4,8
7,19,0,37,7,78.3,3,4
7,20,0,60,10,71.9,3,7
7,21,0,52,11,72.3,5,6
7,22,0,65,10,72.2,4,6
7,23,0,43,9,71.2,3,6
7,24,0,73,14,73.0,6,8
7,25,0,87,17,70.7,6,11
7,26,0,107,22,71.6,8,14
7,27,0,55,10,66.6,4,6
7,28,0,68,16,71.3,8,8
7,29,0,56,10,70.3,5,5
7,30,0,105,23,72.7,10,13
8,1,0,87,7,52.0,2,5
8,2,0,92,8,53.0,3,5
8,3,0,72,7,54.1,1,6
8,4,0,88,7,54.4,3,4
8,5,0,85,7,54.3,2,5
8,6,0,84,10,55.8,0,10
8,7,0,59,6,54.9,3,3
8,8,0,99,11,55.4,1,10
8,9,0,104,13,55.5,2,11
8,10,0,83,9,52.9,5,4
8,11,0,97,12,54.3,5,7
8,12,0,86,15,48.9,3,12
8,13,0,66,10,54.9,4,6
8,14,0,86,13,53.5,6,7
8,15,0,109,15,46.4,5,10
8,16,0,86,13,49.4,7,6
8,17,0,66,12,52.9,4,8
8,18,0,94,15,53.2,2,13
8,19,0,79,12,52.3,4,8
8,20,0,58,9,51.1,4,5
8,21,0,60,12,54.5,6,6
8,22,0,100,16,52.5,7,9
8,23,0,94,16,52.8,4,12
8,24,0,98,20,53.9,6,14
8,25,0,77,15,55.0,4,11
8,26,0,110,21,54.2,10,11
8,27,0,54,12,53.0,5,7
8,28,0,59,16,51.0,4,12
8,29,0,92,17,51.9,5,12
8,30,0,85,21,53.2,10,11
9,1,1,68,16,29.5,10,6
9,2,1,56,14,24.7,4,10
9,3,1,92,26,23.8,14,12
9,4,1,81,22,29.2,10,12
9,5,1,74,22,25.3,12,10
9,6,1,62,19,27.8,10,9
9,7,1,50,16,28.4,9,7
9,8,1,75,27,23.8,11,16
9,9,1,67,24,27.6,10,14
9,10,1,67,25,28.5,10,15
9,11,1,42,16,28.3,5,11
9,12,1,71,26,27.8,7,19
9,13,1,51,21,28.4,12,9
9,14,1,45,19,24.6,9,10
9,15,1,87,35,22.0,16,19
9,16,1,93,41,25.9,21,20
9,17,1,72,33,27.3,18,15
9,18,1,99,48,25.3,25,23
9,19,1,64,30,24.0,14,16
9,20,1,52,28,23.5,17,11
9,21,1,49,23,27.1,13,10
9,22,1,106,54,25.9,37,17
9,23,1,49,28,26.2,9,19
9,24,1,114,62,31.0,29,33
9,25,1,106,59,24.9,29,30
9,26,1,100,56,26.4,31,25
9,27,1,48,29,26.1,13,16
9,28,1,71,45,26.7,26,19
9,29,1,87,55,26.1,34,21
9,30,1,83,49,28.6,31,18
10,1,0,99,12,22.8,10,2
10,2,0,88,7,18.6,3,4
10,3,0,108,9,19.2,6,3
10,4,0,75,7,22.9,7,0
10,5,0,66,6,18.0,4,2
10,6,0,66,10,20.5,6,4
10,7,0,76,9,21.5,6,3
10,8,0,71,11,20.4,7,4
10,9,0,71,8,15.7,7,1
10,10,0,82,11,24.2,6,5
10,11,0,92,14,22.3,9,5
10,12,0,65,10,21.3,7,3
10,13,0,59,9,20.2,6,3
10,14,0,59,7,21.9,4,3
10,15,0,77,11,16.8,9,2
10,16,0,122,17,23.7,14,3
10,17,0,97,14,21.8,10,4
10,18,0,98,17,20.8,12,5
10,19,0,103,16,22.9,10,6
10,20,0,70,11,20.6,6,5
10,21,0,67,12,21.1,10,2
10,22,0,97,18,20.9,13,5
10,23,0,88,16,21.5,13,3
10,24,0,90,15,18.8,12,3
10,25,0,79,16,19.7,10,6
10,26,0,73,14,23.0,8,6
10,27,0,66,12,20.7,7,5
10,28,0,56,11,26.0,7,4
10,29,0,97,18,21.6,13,5
10,30,0,94,23,22.3,14,9
11,1,1,54,12,44.3,8,4
11,2,1,66,15,41.8,9,6
11,3,1,63,17,39.9,9,8
11,4,1,55,13,42.1,8,5
11,5,1,57,16,42.8,7,9
11,6,1,38,16,45.3,8,8
11,7,1,49,17,41.3,7,10
11,8,1,79,26,43.6,9,17
11,9,1,51,20,39.3,11,9
11,10,1,47,18,42.7,10,8
11,11,1,48,18,42.9,11,7
11,12,1,73,28,42.5,17,11
11,13,1,50,20,46.1,10,10
11,14,1,43,16,42.8,9,7
11,15,1,51,22,53.0,15,7
11,16,1,56,26,42.6,14,12
11,17,1,79,35,42.1,17,18
11,18,1,70,32,42.8,17,15
11,19,1,64,32,41.4,10,22
11,20,1,37,19,43.8,7,12
11,21,1,37,18,47.4,8,10
11,22,1,61,33,45.4,17,16
11,23,1,62,32,40.4,14,18
11,24,1,81,43,43.3,18,25
11,25,1,57,34,46.1,19,15
11,26,1,79,45,46.6,26,19
11,27,1,45,26,45.3,9,17
11,28,1,34,23,43.7,13,10
11,29,1,60,39,43.7,22,17
11,30,1,61,37,42.1,21,16
12,1,0,132,10,60.7,5,5
12,2,0,108,9,61.1,4,5
12,3,0,132,13,61.7,2,11
12,4,0,110,10,62.7,3,7
12,5,0,107,11,62.0,6,5
12,6,0,74,9,62.2,3,6
12,7,0,61,5,67.5,1,4
12,8,0,118,18,62.3,6,12
12,9,0,114,13,64.4,2,11
12,10,0,109,13,67.8,6,7
12,11,0,105,19,61.9,7,12
12,12,0,107,16,64.1,7,9
12,13,0,80,11,64.9,3,8
12,14,0,91,13,67.0,4,9
12,15,0,141,19,54.6,8,11
12,16,0,103,15,60.3,4,11
12,17,0,108,17,61.2,7,10
12,18,0,111,20,62.9,6,14
12,19,0,115,18,64.0,5,13
12,20,0,63,12,65.6,5,7
12,21,0,82,13,63.7,8,5
12,22,0,119,21,67.0,10,11
12,23,0,128,23,63.8,9,14
12,24,0,102,18,66.3,5,13
12,25,0,101,20,58.6,7,13
12,26,0,99,20,63.7,7,13
12,27,0,89,17,64.2,8,9
12,28,0,82,17,68.2,9,8
12,29,0,149,35,65.2,11,24
12,30,0,106,24,65.2,10,14
13,1,0,33,4,80.6,2,2
13,2,0,39,3,80.5,2,1
13,3,0,49,4,76.0,3,1
13,4,0,43,3,75.6,2,1
13,5,0,33,3,79.1,3,0
13,6,0,14,4,78.1,2,2
13,7,0,25,4,77.8,3,1
13,8,0,43,5,80.4,3,2
13,9,0,47,6,78.8,6,0
13,10,0,34,7,79.6,2,5
13,11,0,51,8,79.1,4,4
13,12,0,43,5,79.4,5,0
13,13,0,31,5,80.7,4,1
13,14,0,45,5,82.1,3,2
13,15,0,11,6,75.7,2,4
13,16,0,20,3,80.0,2,1
13,17,0,39,8,78.2,6,2
13,18,0,30,6,81.2,4,2
13,19,0,40,11,78.6,9,2
13,20,0,10,3,76.7,1,2
13,21,0,21,4,81.4,1,3
13,22,0,17,3,80.1,3,0
13,23,0,23,4,78.3,3,1
13,24,0,42,10,80.7,5,5
13,25,0,30,9,77.2,4,5
13,26,0,22,5,79.7,5,0
13,27,0,31,10,76.4,7,3
13,28,0,34,10,79.7,7,3
13,29,0,12,5,81.6,4,1
13,30,0,35,11,81.8,5,6
14,1,0,28,6,58.0,4,2
14,2,0,34,4,55.6,1,3
14,3,0,45,9,57.2,2,7
14,4,0,28,4,52.6,4,0
14,5,0,24,4,55.9,2,2
14,6,0,19,2,56.7,1,1
14,7,0,21,6,53.7,5,1
14,8,0,0,5,56.5,4,1
14,9,0,31,5,59.6,4,1
14,10,0,45,8,55.3,2,6
14,11,0,16,1,52.1,1,0
14,12,0,29,4,53.1,2,2
14,13,0,21,4,57.4,3,1
14,14,0,28,5,55.2,5,0
14,15,0,41,8,57.2,3,5
14,16,0,40,8,54.2,5,3
14,17,0,34,7,55.5,4,3
14,18,0,29,4,52.0,3,1
14,19,0,42,8,55.1,6,2
14,20,0,37,7,55.2,5,2
14,21,0,19,4,58.3,4,0
14,22,0,40,7,60.7,6,1
14,23,0,33,9,56.4,8,1
14,24,0,2,3,57.7,2,1
14,25,0,40,9,59.0,4,5
14,26,0,20,5,53.2,1,4
14,27,0,5,3,56.5,1,2
14,28,0,8,2,57.3,2,0
14,29,0,24,6,57.6,4,2
14,30,0,36,9,53.6,2,7
15,1,1,57,14,76.5,5,9
15,2,1,83,18,81.9,7,11
15,3,1,59,15,75.1,8,7
15,4,1,53,13,76.6,9,4
15,5,1,37,9,82.1,7,2
15,6,1,46,16,77.2,9,7
15,7,1,36,14,78.1,9,5
15,8,1,49,18,80.2,9,9
15,9,1,51,16,77.9,5,11
15,10,1,89,31,76.8,17,14
15,11,1,34,11,75.5,4,7
15,12,1,41,15,75.3,10,5
15,13,1,29,12,77.1,7,5
15,14,1,30,14,78.7,8,6
15,15,1,64,25,88.2,16,9
15,16,1,87,40,76.6,17,23
15,17,1,63,28,77.2,17,11
15,18,1,60,27,76.3,10,17
15,19,1,48,21,77.3,13,8
15,20,1,26,13,78.5,7,6
15,21,1,47,23,75.9,12,11
15,22,1,72,39,77.4,28,11
15,23,1,22,11,76.7,5,6
15,24,1,67,34,79.3,17,17
15,25,1,56,32,74.3,16,16
15,26,1,57,33,77.7,16,17
15,27,1,42,24,73.2,14,10
15,28,1,40,22,75.9,11,11
15,29,1,64,38,77.9,10,28
15,30,1,43,26,79.7,10,16
16,1,0,0,2,32.4,2,0
16,2,0,17,4,34.4,3,1
16,3,0,0,0,35.1,0,0
16,4,0,31,2,33.1,2,0
16,5,0,9,2,29.8,0,2
16,6,0,12,1,32.5,0,1
16,7,0,0,4,30.1,2,2
16,8,0,6,2,33.0,1,1
16,9,0,2,1,31.0,0,1
16,10,0,8,1,30.0,1,0
16,11,0,26,4,30.0,2,2
16,12,0,7,2,28.3,1,1
16,13,0,24,7,29.8,2,5
16,14,0,11,2,33.1,2,0
16,15,0,6,1,36.8,0,1
16,16,0,23,8,30.2,7,1
16,17,0,18,6,34.1,4,2
16,18,0,0,1,32.6,1,0
16,19,0,0,0,30.9,0,0
16,20,0,0,3,34.0,1,2
16,21,0,9,2,29.7,1,1
16,22,0,34,5,31.5,3,2
16,23,0,6,1,34.4,0,1
16,24,0,15,5,33.1,4,1
16,25,0,4,2,33.0,2,0
16,26,0,12,3,28.6,3,0
16,27,0,15,3,31.6,3,0
16,28,0,0,1,29.1,1,0
16,29,0,11,4,33.0,4,0
16,30,0,29,7,37.5,4,3
17,1,0,93,9,35.6,5,4
17,2,0,94,8,35.0,3,5
17,3,0,111,9,35.0,7,2
17,4,0,95,12,31.8,5,7
17,5,0,93,9,34.4,7,2
17,6,0,94,8,35.8,3,5
17,7,0,57,8,31.8,4,4
17,8,0,102,11,31.9,7,4
17,9,0,86,10,35.3,5,5
17,10,0,89,12,32.5,8,4
17,11,0,91,10,32.2,6,4
17,12,0,99,12,31.7,5,7
17,13,0,47,8,33.3,3,5
17,14,0,68,10,32.3,2,8
17,15,0,80,11,30.0,6,5
17,16,0,90,14,34.2,7,7
17,17,0,86,14,34.0,8,6
17,18,0,76,17,36.0,9,8
17,19,0,81,14,31.0,10,4
17,20,0,71,15,31.7,8,7
17,21,0,62,10,31.2,5,5
17,22,0,91,16,32.0,9,7
17,23,0,103,19,31.8,6,13
17,24,0,115,19,32.7,9,10
17,25,0,92,18,32.2,8,10
17,26,0,74,15,32.6,8,7
17,27,0,58,10,32.7,6,4
17,28,0,55,10,33.5,4,6
17,29,0,96,22,37.4,11,11
17,30,0,92,19,34.9,13,6
18,1,0,63,7,61.0,4,3
18,2,0,27,4,58.3,2,2
18,3,0,37,2,59.0,2,0
18,4,0,83,9,60.6,7,2
18,5,0,85,8,58.2,5,3
18,6,0,38,5,57.8,0,5
18,7,0,32,5,57.4,0,5
18,8,0,57,6,54.8,3,3
18,9,0,42,5,59.2,2,3
18,10,0,71,8,56.6,4,4
18,11,0,48,6,56.5,2,4
18,12,0,40,9,55.6,5,4
18,13,0,33,7,58.0,4,3
18,14,0,42,6,57.2,3,3
18,15,0,39,11,65.5,5,6
18,16,0,61,9,58.5,5,4
18,17,0,56,10,55.5,4,6
18,18,0,63,11,53.8,7,4
18,19,0,63,11,56.5,8,3
18,20,0,56,8,62.6,4,4
18,21,0,25,7,60.6,3,4
18,22,0,64,14,53.2,9,5
18,23,0,66,11,55.1,7,4
18,24,0,64,12,52.6,8,4
18,25,0,64,12,55.6,4,8
18,26,0,79,15,56.8,10,5
18,27,0,41,9,54.1,5,4
18,28,0,44,11,57.4,6,5
18,29,0,46,10,56.3,7,3
18,30,0,41,10,58.4,4,6
19,1,0,26,1,58.1,0,1
19,2,0,15,3,54.7,2,1
19,3,0,15,2,58.9,1,1
19,4,0,22,2,59.8,1,1
19,5,0,44,4,55.9,2,2
19,6,0,18,1,54.0,0,1
19,7,0,20,2,61.9,1,1
19,8,0,27,3,57.5,1,2
19,9,0,34,3,56.1,1,2
19,10,0,60,7,56.1,2,5
19,11,0,48,8,59.1,3,5
19,12,0,33,8,58.0,1,7
19,13,0,14,3,59.1,2,1
19,14,0,32,4,54.2,1,3
19,15,0,18,2,46.5,2,0
19,16,0,37,7,56.9,3,4
19,17,0,40,7,56.6,5,2
19,18,0,30,8,54.3,5,3
19,19,0,32,4,53.6,2,2
19,20,0,33,8,60.1,6,2
19,21,0,21,4,53.6,2,2
19,22,0,35,7,57.3,5,2
19,23,0,36,8,54.9,4,4
19,24,0,15,7,57.8,2,5
19,25,0,42,8,58.1,5,3
19,26,0,4,6,56.2,4,2
19,27,0,20,4,60.0,3,1
19,28,0,21,11,56.8,6,5
19,29,0,13,3,57.7,0,3
19,30,0,36,8,53.3,2,6
20,1,0,113,9,52.2,4,5
20,2,0,125,11,52.2,6,5
20,3,0,66,9,53.8,3,6
20,4,0,96,13,54.2,6,7
20,5,0,95,8,54.3,4,4
20,6,0,80,7,53.8,6,1
20,7,0,81,9,53.8,4,5
20,8,0,102,13,56.4,7,6
20,9,0,128,13,54.1,8,5
20,10,0,127,15,53.4,8,7
20,11,0,104,14,52.5,8,6
20,12,0,79,13,55.7,3,10
20,13,0,62,7,52.8,4,3
20,14,0,79,12,53.9,7,5
20,15,0,104,14,71.4,9,5
20,16,0,104,17,52.5,10,7
20,17,0,126,19,51.3,10,9
20,18,0,104,15,55.3,7,8
20,19,0,89,13,56.1,6,7
20,20,0,79,14,51.6,4,10
20,21,0,71,15,50.0,7,8
20,22,0,87,16,54.2,7,9
20,23,0,109,18,55.1,10,8
20,24,0,138,24,50.9,15,9
20,25,0,131,25,53.0,14,11
20,26,0,113,23,54.6,14,9
20,27,0,73,14,56.5,5,9
20,28,0,78,16,52.9,8,8
20,29,0,99,22,54.9,14,8
20,30,0,92,21,52.8,11,10
21,1,1,84,19,47.8,9,10
21,2,1,71,18,50.8,12,6
21,3,1,95,26,47.3,11,15
21,4,1,51,12,51.6,8,4
21,5,1,71,18,48.2,7,11
21,6,1,65,21,47.9,12,9
21,7,1,43,17,45.2,6,11
21,8,1,71,23,53.5,8,15
21,9,1,67,24,48.8,9,15
21,10,1,94,34,52.6,22,12
21,11,1,87,32,47.5,14,18
21,12,1,86,31,47.9,16,15
21,13,1,64,25,45.9,12,13
21,14,1,66,27,47.3,16,11
21,15,1,113,45,51.0,23,22
21,16,1,65,26,48.4,13,13
21,17,1,88,39,50.6,15,24
21,18,1,91,41,49.2,19,22
21,19,1,67,31,50.0,14,17
21,20,1,64,32,49.2,17,15
21,21,1,61,31,47.2,18,13
21,22,1,67,36,48.7,18,18
21,23,1,93,49,43.9,17,32
21,24,1,76,41,45.3,16,25
21,25,1,110,60,47.8,31,29
21,26,1,75,41,47.3,23,18
21,27,1,66,40,49.0,19,21
21,28,1,55,36,49.0,18,18
21,29,1,110,65,46.6,32,33
21,30,1,88,54,45.6,34,20
22,1,0,110,8,73.5,3,5
22,2,0,119,9,78.0,3,6
22,3,0,141,12,75.4,7,5
22,4,0,120,12,77.0,6,6
22,5,0,129,15,73.8,4,11
22,6,0,102,10,76.2,4,6
22,7,0,77,9,76.4,5,4
22,8,0,85,10,76.7,8,2
22,9,0,110,13,75.9,5,8
22,10,0,126,14,75.1,7,7
22,11,0,124,20,74.1,7,13
22,12,0,101,12,74.8,2,10
22,13,0,82,10,73.7,6,4
22,14,0,87,13,76.2,5,8
22,15,0,105,15,78.9,9,6
22,16,0,118,19,75.4,10,9
22,17,0,128,18,75.3,8,10
22,18,0,118,18,76.3,7,11
22,19,0,136,23,76.5,12,11
22,20,0,86,15,74.4,9,6
22,21,0,82,14,74.9,10,4
22,22,0,141,25,78.0,15,10
22,23,0,124,22,76.9,11,11
22,24,0,131,23,75.5,9,14
22,25,0,98,19,75.5,11,8
22,26,0,101,23,73.3,12,11
22,27,0,66,14,73.3,7,7
22,28,0,62,12,75.8,7,5
22,29,0,109,26,76.3,11,15
22,30,0,154,32,75.3,18,14
23,1,0,28,2,76.3,1,1
23,2,0,0,0,76.3,0,0
23,3,0,24,3,76.4,1,2
23,4,0,2,2,69.4,0,2
23,5,0,25,7,77.1,3,4
23,6,0,30,3,73.2,1,2
23,7,0,18,1,77.1,1,0
23,8,0,17,3,73.7,1,2
23,9,0,34,3,78.1,1,2
23,10,0,29,6,76.0,1,5
23,11,0,32,6,73.0,2,4
23,12,0,59,7,74.9,2,5
23,13,0,30,6,73.1,1,5
23,14,0,44,8,71.5,1,7
23,15,0,46,9,80.7,2,7
23,16,0,31,5,73.5,4,1
23,17,0,26,6,75.1,3,3
23,18,0,28,6,72.2,2,4
23,19,0,42,7,75.3,1,6
23,20,0,40,8,73.8,2,6
23,21,0,20,5,71.7,2,3
23,22,0,51,9,71.8,2,7
23,23,0,22,5,73.5,4,1
23,24,0,55,11,72.6,4,7
23,25,0,14,5,74.4,0,5
23,26,0,22,4,75.1,1,3
23,27,0,12,3,72.9,0,3
23,28,0,8,6,75.4,2,4
23,29,0,68,18,74.9,8,10
23,30,0,46,9,75.3,4,5
24,1,1,75,16,24.1,12,4
24,2,1,76,17,23.9,5,12
24,3,1,55,14,26.9,6,8
24,4,1,84,21,27.9,8,13
24,5,1,73,21,24.1,9,12
24,6,1,39,13,24.9,6,7
24,7,1,45,13,23.8,7,6
24,8,1,38,12,29.1,6,6
24,9,1,51,16,27.3,8,8
24,10,1,48,17,23.8,8,9
24,11,1,68,25,26.2,11,14
24,12,1,91,35,28.8,16,19
24,13,1,46,21,28.0,12,9
24,14,1,29,12,24.9,7,5
24,15,1,56,24,34.0,15,9
24,16,1,80,36,24.4,14,22
24,17,1,86,40,24.3,20,20
24,18,1,39,21,28.6,8,13
24,19,1,51,24,26.7,12,12
24,20,1,38,18,24.2,7,11
24,21,1,34,16,24.3,8,8
24,22,1,50,24,23.7,9,15
24,23,1,64,37,24.9,21,16
24,24,1,44,23,28.5,15,8
24,25,1,96,52,27.3,32,20
24,26,1,74,41,24.3,22,19
24,27,1,43,26,27.1,12,14
24,28,1,22,14,28.4,7,7
24,29,1,58,38,24.4,16,22
24,30,1,68,40,28.4,23,17
25,1,0,90,7,43.1,3,4
25,2,0,84,7,42.6,3,4
25,3,0,111,8,45.2,8,0
25,4,0,75,11,40.3,4,7
25,5,0,94,10,43.6,6,4
25,6,0,46,5,39.6,4,1
25,7,0,75,8,42.3,5,3
25,8,0,121,13,39.2,9,4
25,9,0,101,15,42.6,9,6
25,10,0,90,12,40.7,9,3
25,11,0,81,14,44.7,6,8
25,12,0,107,12,45.2,7,5
25,13,0,68,11,42.4,8,3
25,14,0,56,10,46.8,6,4
25,15,0,93,13,42.3,11,2
25,16,0,109,16,42.6,9,7
25,17,0,96,15,42.1,10,5
25,18,0,71,13,44.5,8,5
25,19,0,77,14,41.7,5,9
25,20,0,84,16,41.2,8,8
25,21,0,51,8,42.3,6,2
25,22,0,72,12,42.1,8,4
25,23,0,68,11,41.9,9,2
25,24,0,88,16,40.2,8,8
25,25,0,88,20,39.9,14,6
25,26,0,95,21,38.4,12,9
25,27,0,60,12,37.4,9,3
25,28,0,51,11,38.4,7,4
25,29,0,134,30,42.3,18,12
25,30,0,74,16,44.4,8,8
26,1,0,37,4,67.6,2,2
26,2,0,66,6,67.0,2,4
26,3,0,37,4,67.7,1,3
26,4,0,40,5,68.2,3,2
26,5,0,30,3,65.7,1,2
26,6,0,45,7,68.3,5,2
26,7,0,13,3,68.2,2,1
26,8,0,45,6,65.8,5,1
26,9,0,1,2,66.9,0,2
26,10,0,48,6,67.2,3,3
26,11,0,33,4,65.2,3,1
26,12,0,37,7,65.0,5,2
26,13,0,8,1,71.5,1,0
26,14,0,25,4,67.6,2,2
26,15,0,20,4,72.1,2,2
26,16,0,57,7,68.7,5,2
26,17,0,24,5,71.8,4,1
26,18,0,37,6,72.1,2,4
26,19,0,38,7,69.2,3,4
26,20,0,11,2,66.8,1,1
26,21,0,36,11,68.3,8,3
26,22,0,52,9,69.2,6,3
26,23,0,44,7,64.4,5,2
26,24,0,13,4,68.9,1,3
26,25,0,32,9,68.1,6,3
26,26,0,42,8,72.0,5,3
26,27,0,29,5,69.6,3,2
26,28,0,23,6,68.2,5,1
26,29,0,63,14,67.5,7,7
26,30,0,20,6,67.7,4,2
27,1,0,0,2,69.7,1,1
27,2,0,41,7,67.5,3,4
27,3,0,10,2,68.1,1,1
27,4,0,12,4,71.4,3,1
27,5,0,11,2,68.2,0,2
27,6,0,24,3,71.1,1,2
27,7,0,3,0,73.0,0,0
27,8,0,42,6,72.0,2,4
27,9,0,39,10,68.8,7,3
27,10,0,19,3,74.5,0,3
27,11,0,44,9,73.3,2,7
27,12,0,36,5,72.3,3,2
27,13,0,18,4,73.4,2,2
27,14,0,33,6,72.4,3,3
27,15,0,35,8,70.8,0,8
27,16,0,31,6,71.3,3,3
27,17,0,27,6,71.5,2,4
27,18,0,34,5,70.1,2,3
27,19,0,22,6,71.9,1,5
27,20,0,12,1,70.0,1,0
27,21,0,24,4,67.6,3,1
27,22,0,40,9,69.8,1,8
27,23,0,30,5,68.8,2,3
27,24,0,10,4,71.1,2,2
27,25,0,24,9,66.2,2,7
27,26,0,0,0,71.8,0,0
27,27,0,12,4,68.9,1,3
27,28,0,29,7,69.6,1,6
27,29,0,18,4,72.7,2,2
27,30,0,53,10,71.3,3,7
28,1,0,56,6,38.6,3,3
28,2,0,64,6,41.3,4,2
28,3,0,61,6,37.7,2,4
28,4,0,61,7,39.5,2,5
28,5,0,68,8,39.5,2,6
28,6,0,47,4,39.5,0,4
28,7,0,46,4,34.9,1,3
28,8,0,50,5,40.0,3,2
28,9,0,58,7,39.9,2,5
28,10,0,20,4,41.0,2,2
28,11,0,60,8,39.3,2,6
28,12,0,77,10,38.1,1,9
28,13,0,51,7,40.8,5,2
28,14,0,41,10,39.3,5,5
28,15,0,45,10,40.2,2,8
28,16,0,62,10,40.9,4,6
28,17,0,65,11,41.3,3,8
28,18,0,37,6,36.6,2,4
28,19,0,25,6,39.5,5,1
28,20,0,41,8,40.7,2,6
28,21,0,47,9,42.0,3,6
28,22,0,45,10,41.4,2,8
28,23,0,77,17,39.8,5,12
28,24,0,78,13,41.3,5,8
28,25,0,70,14,41.3,1,13
28,26,0,49,8,40.9,2,6
28,27,0,47,9,39.5,4,5
28,28,0,43,9,38.9,1,8
28,29,0,71,14,38.0,6,8
28,30,0,52,11,39.0,4,7
29,1,0,98,6,73.7,3,3
29,2,0,58,5,69.7,1,4
29,3,0,78,9,73.9,4,5
29,4,0,87,9,73.7,5,4
29,5,0,97,9,69.2,3,6
29,6,0,62,7,71.0,5,2
29,7,0,52,7,72.9,4,3
29,8,0,93,10,71.5,5,5
29,9,0,78,10,70.7,6,4
29,10,0,95,13,69.9,6,7
29,11,0,96,12,70.2,10,2
29,12,0,51,8,70.3,4,4
29,13,0,49,8,72.8,3,5
29,14,0,71,10,69.6,5,5
29,15,0,92,13,78.6,7,6
29,16,0,107,19,71.5,13,6
29,17,0,99,14,70.4,10,4
29,18,0,45,9,71.9,4,5
29,19,0,68,14,72.0,8,6
29,20,0,68,14,72.8,6,8
29,21,0,48,8,72.8,6,2
29,22,0,73,14,68.5,8,6
29,23,0,91,17,72.0,8,9
29,24,0,86,15,72.0,7,8
29,25,0,104,18,68.1,6,12
29,26,0,87,15,71.8,10,5
29,27,0,71,15,68.4,6,9
29,28,0,67,13,68.2,5,8
29,29,0,91,19,73.5,10,9
29,30,0,83,18,71.5,5,13
30,1,0,40,4,72.5,1,3
30,2,0,53,4,69.8,0,4
30,3,0,23,2,69.4,0,2
30,4,0,41,4,69.8,3,1
30,5,0,71,7,70.0,3,4
30,6,0,39,5,68.3,2,3
30,7,0,26,3,72.1,1,2
30,8,0,55,5,68.8,3,2
30,9,0,35,4,70.2,1,3
30,10,0,54,8,73.6,5,3
30,11,0,66,8,67.1,1,7
30,12,0,67,10,71.6,1,9
30,13,0,21,5,67.7,2,3
30,14,0,17,3,70.1,0,3
30,15,0,52,10,69.8,5,5
30,16,0,40,8,70.7,3,5
30,17,0,44,9,68.3,2,7
30,18,0,62,10,70.0,2,8
30,19,0,40,9,72.4,2,7
30,20,0,32,5,73.3,1,4
30,21,0,42,7,70.6,5,2
30,22,0,46,10,72.3,6,4
30,23,0,59,10,68.7,3,7
30,24,0,47,11,71.2,3,8
30,25,0,59,13,69.5,5,8
30,26,0,53,10,69.0,1,9
30,27,0,40,8,69.6,2,6
30,28,0,52,11,73.8,2,9
30,29,0,55,12,71.6,4,8
30,30,0,63,15,72.4,7,8
31,1,1,72,18,28.7,10,8
31,2,1,54,13,24.9,4,9
31,3,1,100,26,29.4,18,8
31,4,1,72,20,27.3,6,14
31,5,1,104,27,25.3,14,13
31,6,1,58,16,27.7,11,5
31,7,1,66,21,29.6,15,6
31,8,1,92,32,25.1,13,19
31,9,1,99,31,28.3,16,15
31,10,1,71,25,26.3,8,17
31,11,1,105,39,28.1,17,22
31,12,1,73,26,30.2,11,15
31,13,1,49,21,29.3,7,14
31,14,1,58,25,26.4,11,14
31,15,1,94,38,23.5,24,14
31,16,1,77,32,27.6,20,12
31,17,1,90,39,30.0,18,21
31,18,1,76,33,26.0,17,16
31,19,1,79,36,30.8,17,19
31,20,1,68,32,25.9,15,17
31,21,1,62,32,25.8,17,15
31,22,1,95,46,27.9,24,22
31,23,1,77,40,25.7,22,18
31,24,1,99,54,28.5,33,21
31,25,1,93,50,29.0,19,31
31,26,1,66,39,26.6,20,19
31,27,1,47,26,33.6,20,6
31,28,1,83,50,26.4,22,28
31,29,1,84,52,29.3,31,21
31,30,1,70,43,28.1,23,20
32,1,1,101,25,42.1,13,12
32,2,1,101,24,42.0,14,10
32,3,1,117,28,40.5,9,19
32,4,1,145,39,40.9,17,22
32,5,1,80,22,40.4,7,15
32,6,1,84,24,41.0,4,20
32,7,1,79,27,37.9,12,15
32,8,1,105,32,41.9,20,12
32,9,1,89,31,42.4,14,17
32,10,1,123,42,37.8,23,19
32,11,1,115,41,39.0,17,24
32,12,1,96,39,37.7,26,13
32,13,1,68,26,43.8,16,10
32,14,1,62,25,40.0,15,10
32,15,1,93,40,46.6,20,20
32,16,1,109,47,39.9,21,26
32,17,1,113,51,40.4,29,22
32,18,1,108,50,40.3,23,27
32,19,1,95,47,39.8,31,16
32,20,1,72,37,40.8,24,13
32,21,1,85,40,39.7,21,19
32,22,1,104,53,45.8,35,18
32,23,1,109,55,40.0,26,29
32,24,1,120,63,39.8,38,25
32,25,1,125,69,42.6,45,24
32,26,1,95,53,39.6,22,31
32,27,1,81,49,40.0,23,26
32,28,1,83,48,38.1,21,27
32,29,1,131,82,42.2,44,38
32,30,1,95,61,40.2,31,30
33,1,0,94,7,47.9,4,3
33,2,0,49,5,52.8,3,2
33,3,0,75,6,49.2,4,2
33,4,0,79,6,52.1,2,4
33,5,0,84,8,50.4,5,3
33,6,0,54,10,53.1,8,2
33,7,0,55,10,49.0,8,2
33,8,0,105,12,46.3,6,6
33,9,0,83,10,46.3,8,2
33,10,0,83,10,48.3,5,5
33,11,0,61,7,47.3,3,4
33,12,0,93,13,47.6,8,5
33,13,0,73,11,46.7,5,6
33,14,0,60,8,49.4,4,4
33,15,0,96,13,53.1,9,4
33,16,0,83,14,50.0,8,6
33,17,0,112,15,47.3,7,8
33,18,0,98,16,46.1,10,6
33,19,0,66,11,48.4,10,1
33,20,0,80,14,48.5,11,3
33,21,0,67,12,45.2,7,5
33,22,0,74,16,49.1,3,13
33,23,0,112,21,47.4,11,10
33,24,0,109,20,46.9,12,8
33,25,0,111,22,49.0,16,6
33,26,0,92,17,47.8,14,3
33,27,0,50,11,50.3,4,7
33,28,0,69,14,48.7,10,4
33,29,0,60,12,47.7,9,3
33,30,0,70,16,47.8,10,6
34,1,0,44,4,81.3,1,3
34,2,0,56,5,81.0,2,3
34,3,0,33,4,76.9,2,2
34,4,0,37,5,81.3,3,2
34,5,0,43,5,76.0,3,2
34,6,0,35,3,83.2,2,1
34,7,0,13,2,80.2,0,2
34,8,0,30,3,77.8,1,2
34,9,0,57,9,83.2,5,4
34,10,0,33,3,80.7,2,1
34,11,0,24,3,81.3,1,2
34,12,0,12,3,81.2,3,0
34,13,0,21,3,83.6,2,1
34,14,0,20,2,81.7,2,0
34,15,0,67,10,77.9,9,1
34,16,0,53,9,78.8,6,3
34,17,0,14,7,80.5,3,4
34,18,0,40,8,83.1,8,0
34,19,0,33,7,81.4,7,0
34,20,0,31,4,79.4,3,1
34,21,0,25,6,78.8,1,5
34,22,0,36,10,80.1,5,5
34,23,0,36,11,80.1,9,2
34,24,0,35,6,77.8,3,3
34,25,0,20,6,80.4,4,2
34,26,0,36,9,82.1,7,2
34,27,0,9,1,78.4,0,1
34,28,0,35,9,77.8,5,4
34,29,0,48,11,83.5,8,3
34,30,0,46,11,80.5,8,3
35,1,0,33,3,16.7,2,1
35,2,0,31,3,22.5,1,2
35,3,0,52,5,20.0,4,1
35,4,0,52,9,16.5,2,7
35,5,0,70,7,18.4,3,4
35,6,0,27,4,21.4,0,4
35,7,0,29,4,20.7,0,4
35,8,0,35,4,21.4,1,3
35,9,0,41,4,20.5,2,2
35,10,0,31,4,19.3,1,3
35,11,0,62,9,23.0,2,7
35,12,0,36,4,22.6,2,2
35,13,0,33,5,20.2,1,4
35,14,0,41,6,19.2,1,5
35,15,0,62,9,19.9,2,7
35,16,0,20,6,18.1,1,5
35,17,0,39,6,19.8,4,2
35,18,0,16,4,21.0,2,2
35,19,0,29,7,19.1,2,5
35,20,0,37,10,17.7,2,8
35,21,0,27,4,21.1,2,2
35,22,0,60,13,19.2,4,9
35,23,0,49,13,19.4,4,9
35,24,0,32,6,17.6,1,5
35,25,0,29,6,20.1,3,3
35,26,0,17,4,17.4,1,3
35,27,0,45,9,14.8,1,8
35,28,0,20,6,18.0,2,4
35,29,0,20,6,20.6,3,3
35,30,0,47,12,19.5,5,7
36,1,0,26,3,64.8,0,3
36,2,0,37,5,65.7,1,4
36,3,0,41,5,67.4,1,4
36,4,0,43,5,67.1,4,1
36,5,0,31,5,61.3,0,5
36,6,0,13,3,61.3,2,1
36,7,0,49,7,63.8,2,5
36,8,0,33,4,66.2,2,2
36,9,0,3,1,65.7,1,0
36,10,0,59,8,69.8,5,3
36,11,0,39,7,66.2,3,4
36,12,0,22,5,65.1,3,2
36,13,0,3,3,63.1,0,3
36,14,0,20,4,65.1,2,2
36,15,0,24,6,61.2,3,3
36,16,0,55,9,66.3,8,1
36,17,0,34,5,63.5,2,3
36,18,0,50,7,66.1,3,4
36,19,0,19,3,65.6,0,3
36,20,0,15,3,65.2,2,1
36,21,0,9,2,63.5,1,1
36,22,0,20,5,70.4,0,5
36,23,0,34,10,67.0,3,7
36,24,0,33,6,64.9,0,6
36,25,0,39,7,63.7,2,5
36,26,0,38,7,64.3,3,4
36,27,0,25,5,65.5,2,3
36,28,0,22,5,65.9,4,1
36,29,0,47,12,67.4,8,4
36,30,0,22,8,63.8,3,5
37,1,0,45,4,43.0,2,2
37,2,0,25,4,40.7,2,2
37,3,0,45,5,39.7,3,2
37,4,0,20,3,44.4,0,3
37,5,0,19,2,39.3,1,1
37,6,0,31,5,38.5,3,2
37,7,0,9,4,40.0,2,2
37,8,0,14,3,40.6,0,3
37,9,0,6,2,37.1,0,2
37,10,0,25,5,40.2,3,2
37,11,0,56,7,40.2,5,2
37,12,0,0,0,40.3,0,0
37,13,0,43,9,38.4,5,4
37,14,0,0,1,37.6,0,1
37,15,0,8,5,36.6,1,4
37,16,0,10,2,38.9,2,0
37,17,0,16,4,41.1,3,1
37,18,0,54,9,39.0,3,6
37,19,0,28,4,41.5,3,1
37,20,0,31,7,42.7,6,1
37,21,0,0,0,43.6,0,0
37,22,0,16,3,38.3,2,1
37,23,0,39,6,43.0,2,4
37,24,0,28,6,38.0,3,3
37,25,0,14,5,38.3,2,3
37,26,0,29,9,41.8,6,3
37,27,0,9,1,39.5,0,1
37,28,0,12,5,38.0,4,1
37,29,0,29,8,42.2,4,4
37,30,0,40,11,40.3,5,6
38,1,0,31,2,55.1,1,1
38,2,0,0,2,54.5,2,0
38,3,0,17,2,55.7,0,2
38,4,0,1,1,53.1,0,1
38,5,0,27,3,55.8,1,2
38,6,0,10,2,50.9,0,2
38,7,0,27,8,53.2,4,4
38,8,0,15,3,53.2,1,2
38,9,0,13,1,54.9,0,1
38,10,0,33,4,56.2,2,2
38,11,0,38,6,53.9,4,2
38,12,0,41,8,53.8,2,6
38,13,0,12,2,53.5,0,2
38,14,0,1,2,56.2,0,2
38,15,0,43,6,59.1,1,5
38,16,0,17,5,57.2,0,5
38,17,0,15,5,52.3,1,4
38,18,0,17,4,53.4,0,4
38,19,0,37,6,53.3,5,1
38,20,0,0,4,56.5,2,2
38,21,0,10,4,51.9,2,2
38,22,0,25,8,53.6,4,4
38,23,0,21,3,58.0,2,1
38,24,0,39,8,55.8,2,6
38,25,0,0,2,54.4,2,0
38,26,0,18,4,53.6,1,3
38,27,0,0,2,54.4,0,2
38,28,0,20,4,51.1,1,3
38,29,0,23,6,52.8,1,5
38,30,0,25,7,54.4,3,4
39,1,0,104,8,24.0,7,1
39,2,0,107,11,19.5,6,5
39,3,0,89,8,21.2,3,5
39,4,0,97,8,17.7,5,3
39,5,0,89,8,19.0,7,1
39,6,0,64,6,17.8,4,2
39,7,0,83,11,19.4,9,2
39,8,0,78,7,18.2,4,3
39,9,0,88,10,20.2,5,5
39,10,0,102,15,21.0,10,5
39,11,0,89,11,21.1,7,4
39,12,0,90,10,19.7,7,3
39,13,0,80,13,18.6,5,8
39,14,0,69,11,22.0,8,3
39,15,0,102,16,29.9,12,4
39,16,0,88,14,20.8,5,9
39,17,0,121,19,19.1,15,4
39,18,0,115,17,20.0,11,6
39,19,0,96,15,19.0,7,8
39,20,0,80,13,19.7,6,7
39,21,0,64,13,19.7,8,5
39,22,0,75,13,23.0,9,4
39,23,0,118,21,19.1,13,8
39,24,0,81,15,22.5,11,4
39,25,0,125,25,19.4,16,9
39,26,0,95,17,23.6,13,4
39,27,0,48,11,21.6,9,2
39,28,0,87,17,19.3,14,3
39,29,0,119,25,21.4,17,8
39,30,0,121,24,20.9,13,11
40,1,0,81,10,64.0,6,4
40,2,0,119,10,63.0,2,8
40,3,0,61,5,67.8,1,4
40,4,0,95,12,64.2,5,7
40,5,0,103,11,65.0,3,8
40,6,0,60,6,65.0,3,3
40,7,0,86,10,67.4,5,5
40,8,0,118,15,62.7,6,9
40,9,0,115,12,62.9,3,9
40,10,0,75,9,65.5,2,7
40,11,0,70,8,62.1,3,5
40,12,0,79,10,63.7,1,9
40,13,0,64,8,61.2,2,6
40,14,0,77,10,62.2,4,6
40,15,0,120,16,68.3,8,8
40,16,0,97,13,68.2,3,10
40,17,0,65,9,62.4,4,5
40,18,0,120,22,59.1,7,15
40,19,0,87,14,61.7,4,10
40,20,0,57,11,65.1,5,6
40,21,0,70,11,62.2,5,6
40,22,0,100,18,64.5,7,11
40,23,0,126,23,66.4,6,17
40,24,0,103,18,62.3,7,11
40,25,0,122,23,64.6,10,13
40,26,0,89,18,62.5,6,12
40,27,0,69,16,60.7,6,10
40,28,0,77,16,63.0,7,9
40,29,0,102,20,64.0,10,10
40,30,0,94,20,64.1,6,14
41,1,0,16,3,19.8,2,1
41,2,0,25,5,20.5,3,2
41,3,0,1,0,21.3,0,0
41,4,0,28,4,21.4,2,2
41,5,0,35,4,18.0,2,2
41,6,0,23,3,21.7,3,0
41,7,0,24,5,23.0,4,1
41,8,0,42,4,23.4,2,2
41,9,0,15,1,18.6,0,1
41,10,0,28,4,19.9,3,1
41,11,0,37,5,18.9,2,3
41,12,0,24,5,20.9,2,3
41,13,0,17,6,22.2,3,3
41,14,0,31,6,24.9,2,4
41,15,0,32,5,15.6,3,2
41,16,0,10,4,22.0,3,1
41,17,0,36,6,21.2,3,3
41,18,0,10,2,23.4,1,1
41,19,0,42,8,20.0,2,6
41,20,0,21,3,22.5,2,1
41,21,0,22,4,24.4,0,4
41,22,0,2,2,21.4,2,0
41,23,0,48,9,22.5,6,3
41,24,0,34,7,19.6,2,5
41,25,0,34,8,22.6,2,6
41,26,0,27,8,20.5,5,3
41,27,0,14,5,18.9,0,5
41,28,0,15,4,22.2,0,4
41,29,0,57,12,22.6,7,5
41,30,0,37,11,20.4,5,6
42,1,0,113,11,19.4,9,2
42,2,0,102,10,20.6,7,3
42,3,0,116,12,20.2,9,3
42,4,0,90,7,24.3,4,3
42,5,0,105,10,21.1,7,3
42,6,0,62,6,18.7,2,4
42,7,0,58,6,19.8,3,3
42,8,0,92,13,21.2,6,7
42,9,0,65,7,21.1,3,4
42,10,0,52,6,25.5,2,4
42,11,0,113,15,23.0,6,9
42,12,0,82,12,25.4,10,2
42,13,0,64,7,25.9,5,2
42,14,0,64,11,19.8,8,3
42,15,0,112,18,26.4,9,9
42,16,0,84,17,23.7,14,3
42,17,0,108,18,23.7,10,8
42,18,0,86,14,22.3,13,1
42,19,0,109,17,22.6,11,6
42,20,0,70,11,23.0,8,3
42,21,0,71,12,24.2,7,5
42,22,0,122,22,23.2,14,8
42,23,0,105,17,21.6,11,6
42,24,0,83,19,19.9,8,11
42,25,0,79,15,21.3,9,6
42,26,0,118,25,25.9,16,9
42,27,0,55,13,21.4,10,3
42,28,0,73,15,22.1,11,4
42,29,0,119,25,21.0,15,10
42,30,0,95,22,26.2,12,10
43,1,0,7,3,34.6,1,2
43,2,0,16,4,28.7,3,1
43,3,0,41,5,34.8,4,1
43,4,0,44,3,31.0,2,1
43,5,0,5,1,31.7,1,0
43,6,0,32,8,29.4,6,2
43,7,0,36,5,32.7,2,3
43,8,0,57,8,32.8,4,4
43,9,0,39,8,30.7,4,4
43,10,0,34,5,30.1,2,3
43,11,0,57,6,31.4,4,2
43,12,0,40,7,36.7,1,6
43,13,0,25,8,27.6,3,5
43,14,0,28,4,37.3,2,2
43,15,0,38,7,33.0,4,3
43,16,0,49,7,31.6,4,3
43,17,0,29,4,34.0,2,2
43,18,0,43,9,30.0,6,3
43,19,0,6,2,30.6,2,0
43,20,0,34,10,31.8,5,5
43,21,0,35,9,29.7,3,6
43,22,0,55,10,30.8,6,4
43,23,0,36,6,31.6,3,3
43,24,0,25,5,29.7,3,2
43,25,0,23,5,27.3,3,2
43,26,0,30,13,31.4,4,9
43,27,0,28,8,30.7,3,5
43,28,0,26,5,32.5,2,3
43,29,0,16,5,32.5,4,1
43,30,0,16,4,33.3,0,4
44,1,1,75,16,25.0,8,8
44,2,1,63,16,23.2,10,6
44,3,1,63,19,27.3,9,10
44,4,1,88,26,23.4,15,11
44,5,1,75,22,27.0,7,15
44,6,1,34,13,28.5,4,9
44,7,1,64,21,25.7,11,10
44,8,1,95,33,24.1,17,16
44,9,1,74,24,25.4,13,11
44,10,1,68,23,25.2,17,6
44,11,1,87,34,26.7,20,14
44,12,1,58,20,24.7,6,14
44,13,1,43,17,26.8,7,10
44,14,1,49,20,29.2,4,16
44,15,1,77,34,30.8,15,19
44,16,1,86,37,26.1,16,21
44,17,1,62,27,25.7,9,18
44,18,1,44,21,27.1,6,15
44,19,1,61,30,22.4,14,16
44,20,1,50,24,25.9,15,9
44,21,1,52,26,23.2,10,16
44,22,1,83,42,25.1,21,21
44,23,1,61,31,28.9,12,19
44,24,1,72,39,22.8,16,23
44,25,1,63,34,25.2,18,16
44,26,1,72,39,26.5,19,20
44,27,1,54,31,25.7,17,14
44,28,1,55,36,27.2,16,20
44,29,1,78,46,24.4,22,24
44,30,1,53,32,26.6,16,16
45,1,0,59,7,72.8,4,3
45,2,0,30,2,72.3,1,1
45,3,0,61,6,75.8,3,3
45,4,0,31,4,70.4,4,0
45,5,0,45,5,74.7,3,2
45,6,0,25,7,75.8,3,4
45,7,0,22,2,73.9,2,0
45,8,0,48,4,73.2,2,2
45,9,0,37,4,75.2,0,4
45,10,0,38,5,74.8,3,2
45,11,0,55,8,73.9,5,3
45,12,0,55,10,73.5,7,3
45,13,0,37,6,76.9,1,5
45,14,0,25,3,76.5,0,3
45,15,0,25,6,72.1,1,5
45,16,0,70,10,76.3,5,5
45,17,0,32,6,72.1,2,4
45,18,0,29,8,73.1,4,4
45,19,0,65,11,75.4,2,9
45,20,0,24,6,72.7,3,3
45,21,0,37,8,77.0,4,4
45,22,0,52,9,72.5,2,7
45,23,0,15,3,75.5,2,1
45,24,0,42,10,72.7,2,8
45,25,0,59,16,71.7,9,7
45,26,0,34,6,74.6,2,4
45,27,0,26,7,71.7,2,5
45,28,0,18,4,69.4,1,3
45,29,0,55,12,72.4,5,7
45,30,0,25,8,75.7,4,4
46,1,0,85,9,67.6,3,6
46,2,0,80,8,67.7,2,6
46,3,0,123,10,66.0,3,7
46,4,0,93,8,70.2,5,3
46,5,0,119,13,67.5,5,8
46,6,0,50,5,67.3,1,4
46,7,0,55,8,70.2,3,5
46,8,0,91,9,68.2,1,8
46,9,0,90,10,66.0,4,6
46,10,0,101,12,69.3,2,10
46,11,0,84,10,67.0,2,8
46,12,0,98,13,67.9,5,8
46,13,0,68,9,68.9,1,8
46,14,0,59,10,70.3,4,6
46,15,0,60,10,71.2,1,9
46,16,0,68,10,67.3,2,8
46,17,0,133,23,67.3,7,16
46,18,0,87,18,68.6,7,11
46,19,0,94,14,68.3,6,8
46,20,0,62,12,64.3,4,8
46,21,0,56,12,66.7,4,8
46,22,0,109,20,68.5,3,17
46,23,0,90,18,67.1,5,13
46,24,0,116,21,67.5,10,11
46,25,0,75,17,66.4,7,10
46,26,0,70,17,71.1,8,9
46,27,0,63,13,67.9,4,9
46,28,0,44,10,65.0,5,5
46,29,0,71,13,67.6,6,7
46,30,0,95,20,68.7,4,16
47,1,0,0,1,35.4,0,1
47,2,0,0,3,41.4,3,0
47,3,0,28,5,43.5,2,3
47,4,0,10,1,39.7,0,1
47,5,0,11,0,38.9,0,0
47,6,0,8,1,42.2,0,1
47,7,0,14,2,39.3,0,2
47,8,0,31,7,40.4,5,2
47,9,0,38,6,37.6,3,3
47,10,0,0,0,43.0,0,0
47,11,0,6,1,40.0,0,1
47,12,0,0,3,39.9,1,2
47,13,0,3,3,39.4,3,0
47,14,0,17,4,39.5,1,3
47,15,0,31,11,40.0,7,4
47,16,0,12,3,40.3,0,3
47,17,0,0,2,40.4,1,1
47,18,0,0,1,37.4,0,1
47,19,0,0,1,37.9,1,0
47,20,0,4,2,39.9,1,1
47,21,0,7,3,41.3,2,1
47,22,0,21,6,39.3,5,1
47,23,0,36,8,39.8,3,5
47,24,0,2,5,39.7,2,3
47,25,0,0,1,42.0,1,0
47,26,0,8,3,37.8,2,1
47,27,0,0,1,35.0,0,1
47,28,0,6,1,41.5,1,0
47,29,0,0,6,39.5,5,1
47,30,0,26,8,40.6,3,5
48,1,0,84,7,48.4,6,1
48,2,0,106,9,54.9,6,3
48,3,0,50,6,52.7,5,1
48,4,0,79,6,48.9,2,4
48,5,0,97,11,50.1,5,6
48,6,0,50,7,51.2,3,4
48,7,0,42,5,52.9,4,1
48,8,0,66,9,48.9,3,6
48,9,0,101,15,51.3,14,1
48,10,0,130,19,49.9,14,5
48,11,0,79,10,50.7,2,8
48,12,0,98,16,51.9,13,3
48,13,0,59,8,49.1,4,4
48,14,0,59,7,52.5,7,0
48,15,0,117,17,45.6,8,9
48,16,0,61,9,49.7,2,7
48,17,0,60,10,51.8,8,2
48,18,0,76,13,52.2,7,6
48,19,0,75,14,52.6,10,4
48,20,0,66,11,48.7,5,6
48,21,0,63,13,50.6,9,4
48,22,0,85,14,50.9,9,5
48,23,0,49,12,51.4,9,3
48,24,0,83,19,47.7,10,9
48,25,0,92,16,52.5,11,5
48,26,0,47,11,52.9,9,2
48,27,0,67,15,51.7,11,4
48,28,0,44,9,49.7,8,1
48,29,0,76,15,53.5,11,4
48,30,0,99,20,48.9,13,7
49,1,1,103,22,66.2,14,8
49,2,1,124,30,71.3,19,11
49,3,1,116,29,72.6,12,17
49,4,1,111,30,70.8,21,9
49,5,1,103,28,71.8,20,8
49,6,1,87,25,65.9,14,11
49,7,1,66,23,71.6,13,10
49,8,1,102,33,72.7,16,17
49,9,1,110,36,71.6,24,12
49,10,1,100,35,69.2,16,19
49,11,1,99,36,69.0,15,21
49,12,1,124,44,67.3,23,21
49,13,1,73,27,69.7,15,12
49,14,1,76,33,71.7,21,12
49,15,1,97,41,60.5,21,20
49,16,1,111,45,69.3,12,33
49,17,1,113,48,66.8,20,28
49,18,1,111,49,69.8,29,20
49,19,1,120,57,69.9,32,25
49,20,1,78,38,70.0,20,18
49,21,1,72,36,71.4,11,25
49,22,1,82,43,72.4,16,27
49,23,1,112,59,72.0,24,35
49,24,1,103,56,69.7,20,36
49,25,1,117,62,71.2,31,31
49,26,1,103,59,70.5,31,28
49,27,1,64,38,66.4,22,16
49,28,1,92,52,71.4,37,15
49,29,1,83,50,69.5,16,34
49,30,1,121,73,71.9,39,34
50,1,1,37,11,18.0,5,6
50,2,1,66,16,21.4,12,4
50,3,1,65,18,19.7,10,8
50,4,1,44,11,20.8,7,4
50,5,1,49,14,16.7,8,6
50,6,1,57,16,21.6,12,4
50,7,1,35,11,18.3,5,6
50,8,1,29,9,20.7,3,6
50,9,1,66,23,20.4,11,12
50,10,1,60,21,21.4,12,9
50,11,1,55,21,20.5,11,10
50,12,1,82,30,20.1,16,14
50,13,1,44,18,20.2,6,12
50,14,1,43,19,19.0,9,10
50,15,1,57,23,23.3,15,8
50,16,1,60,28,19.7,21,7
50,17,1,46,20,23.7,14,6
50,18,1,94,45,20.2,27,18
50,19,1,55,28,18.0,15,13
50,20,1,18,9,21.6,6,3
50,21,1,32,15,18.4,6,9
50,22,1,76,43,20.0,16,27
50,23,1,67,35,24.0,14,21
50,24,1,48,25,19.5,14,11
50,25,1,70,37,21.2,14,23
50,26,1,45,26,20.0,15,11
50,27,1,30,18,22.6,7,11
50,28,1,50,29,15.0,22,7
50,29,1,76,45,19.8,20,25
50,30,1,72,46,25.2,23,23
51,1,0,22,3,44.8,1,2
51,2,0,0,4,43.7,1,3
51,3,0,32,2,45.2,0,2
51,4,0,0,2,43.2,1,1
51,5,0,14,2,45.1,2,0
51,6,0,21,3,46.0,1,2
51,7,0,3,5,45.9,4,1
51,8,0,2,0,45.2,0,0
51,9,0,4,1,46.8,1,0
51,10,0,0,3,45.7,3,0
51,11,0,9,3,46.2,1,2
51,12,0,40,4,49.2,3,1
51,13,0,26,6,45.2,5,1
51,14,0,6,2,44.5,1,1
51,15,0,16,2,45.3,2,0
51,16,0,38,8,44.5,3,5
51,17,0,9,3,47.5,2,1
51,18,0,27,10,45.2,6,4
51,19,0,0,4,49.4,3,1
51,20,0,0,0,45.3,0,0
51,21,0,30,5,44.7,4,1
51,22,0,0,2,42.2,1,1
51,23,0,29,6,47.7,4,2
51,24,0,14,2,44.1,0,2
51,25,0,0,0,41.8,0,0
51,26,0,0,0,41.4,0,0
51,27,0,3,2,41.8,1,1
51,28,0,0,2,42.7,1,1
51,29,0,30,8,43.1,3,5
51,30,0,43,11,39.7,3,8
52,1,0,109,10,56.5,5,5
52,2,0,121,11,57.3,8,3
52,3,0,132,13,59.2,6,7
52,4,0,102,9,59.5,6,3
52,5,0,105,12,54.8,5,7
52,6,0,89,12,58.2,4,8
52,7,0,73,9,51.8,5,4
52,8,0,132,14,60.9,9,5
52,9,0,91,10,58.2,7,3
52,10,0,135,14,61.1,8,6
52,11,0,110,12,59.8,6,6
52,12,0,113,14,61.7,8,6
52,13,0,83,12,59.2,3,9
52,14,0,82,12,60.0,8,4
52,15,0,108,18,50.0,8,10
52,16,0,124,21,59.1,11,10
52,17,0,150,22,60.6,14,8
52,18,0,89,13,58.3,5,8
52,19,0,126,22,59.6,13,9
52,20,0,82,14,58.1,10,4
52,21,0,88,16,62.6,4,12
52,22,0,103,19,62.7,9,10
52,23,0,105,19,59.0,9,10
52,24,0,135,26,56.3,13,13
52,25,0,123,22,61.2,9,13
52,26,0,132,31,61.5,14,17
52,27,0,78,17,60.7,9,8
52,28,0,86,18,60.5,8,10
52,29,0,124,24,58.5,8,16
52,30,0,121,27,55.4,12,15
53,1,0,19,4,34.0,2,2
53,2,0,11,1,27.7,1,0
53,3,0,30,3,30.9,1,2
53,4,0,0,1,30.3,0,1
53,5,0,20,5,30.9,2,3
53,6,0,14,5,37.4,3,2
53,7,0,6,2,36.1,2,0
53,8,0,5,3,34.7,1,2
53,9,0,40,5,31.4,3,2
53,10,0,26,2,28.7,2,0
53,11,0,8,1,33.7,1,0
53,12,0,42,9,31.9,5,4
53,13,0,7,2,34.7,2,0
53,14,0,6,1,30.5,1,0
53,15,0,8,1,40.6,0,1
53,16,0,15,4,31.4,2,2
53,17,0,38,8,32.3,6,2
53,18,0,7,5,32.8,3,2
53,19,0,9,4,31.4,4,0
53,20,0,3,0,32.6,0,0
53,21,0,12,2,37.0,1,1
53,22,0,2,1,34.7,0,1
53,23,0,9,4,32.1,2,2
53,24,0,18,6,31.4,5,1
53,25,0,37,9,30.5,6,3
53,26,0,0,2,33.4,2,0
53,27,0,12,7,34.3,4,3
53,28,0,20,4,37.4,2,2
53,29,0,1,2,30.7,1,1
53,30,0,20,8,34.1,4,4
54,1,0,94,6,76.7,1,5
54,2,0,71,9,77.4,4,5
54,3,0,78,7,72.4,4,3
54,4,0,53,5,74.4,3,2
54,5,0,114,12,76.7,8,4
54,6,0,55,9,76.3,3,6
54,7,0,82,11,76.8,2,9
54,8,0,94,11,75.7,4,7
54,9,0,80,8,74.7,3,5
54,10,0,112,12,77.1,3,9
54,11,0,72,10,74.5,4,6
54,12,0,79,10,72.8,3,7
54,13,0,84,11,78.1,5,6
54,14,0,52,11,77.6,2,9
54,15,0,62,10,74.5,4,6
54,16,0,71,12,80.1,3,9
54,17,0,81,12,75.1,2,10
54,18,0,64,11,76.8,4,7
54,19,0,91,15,71.7,4,11
54,20,0,69,15,74.5,8,7
54,21,0,57,11,76.4,6,5
54,22,0,58,10,77.0,3,7
54,23,0,78,17,74.3,2,15
54,24,0,87,20,74.1,9,11
54,25,0,98,18,75.1,4,14
54,26,0,98,17,80.5,8,9
54,27,0,53,11,72.7,2,9
54,28,0,69,14,71.8,3,11
54,29,0,115,24,75.7,8,16
54,30,0,70,14,77.3,3,11
55,1,0,91,10,75.8,5,5
55,2,0,74,7,75.3,3,4
55,3,0,76,7,78.1,4,3
55,4,0,62,5,79.0,3,2
55,5,0,56,7,80.8,5,2
55,6,0,34,6,78.4,5,1
55,7,0,52,5,82.5,2,3
55,8,0,61,8,78.9,7,1
55,9,0,56,6,81.1,5,1
55,10,0,78,11,78.7,4,7
55,11,0,101,12,80.8,11,1
55,12,0,98,12,77.1,8,4
55,13,0,56,8,79.4,5,3
55,14,0,52,7,78.4,3,4
55,15,0,65,10,82.8,6,4
55,16,0,71,9,80.7,7,2
55,17,0,61,8,79.1,7,1
55,18,0,72,15,78.5,9,6
55,19,0,77,11,79.8,9,2
55,20,0,59,10,79.2,7,3
55,21,0,49,8,80.5,5,3
55,22,0,62,13,80.6,8,5
55,23,0,58,10,79.6,6,4
55,24,0,79,14,80.0,9,5
55,25,0,77,16,78.6,10,6
55,26,0,92,17,79.6,6,11
55,27,0,41,10,77.7,7,3
55,28,0,57,12,80.7,7,5
55,29,0,71,18,76.7,8,10
55,30,0,69,19,80.1,14,5
56,1,0,133,10,43.1,4,6
56,2,0,123,11,42.7,4,7
56,3,0,101,11,44.2,2,9
56,4,0,121,13,47.3,5,8
56,5,0,116,13,40.7,3,10
56,6,0,76,12,43.2,5,7
56,7,0,76,9,45.5,3,6
56,8,0,88,10,45.0,2,8
56,9,0,90,10,44.6,6,4
56,10,0,110,13,44.0,9,4
56,11,0,115,13,43.4,5,8
56,12,0,141,17,41.8,7,10
56,13,0,74,11,43.3,4,7
56,14,0,51,7,41.7,3,4
56,15,0,97,12,33.0,7,5
56,16,0,88,13,40.7,3,10
56,17,0,108,17,39.7,4,13
56,18,0,93,15,42.8,5,10
56,19,0,104,16,42.8,6,10
56,20,0,81,14,47.4,5,9
56,21,0,57,10,43.5,5,5
56,22,0,104,18,40.3,5,13
56,23,0,95,19,39.3,7,12
56,24,0,105,23,38.5,7,16
56,25,0,103,21,46.1,9,12
56,26,0,107,23,43.8,6,17
56,27,0,76,14,44.0,4,10
56,28,0,64,13,44.7,4,9
56,29,0,93,19,43.6,5,14
56,30,0,107,23,41.9,10,13
57,1,1,2,1,75.7,1,0
57,2,1,19,6,77.7,3,3
57,3,1,0,4,72.1,2,2
57,4,1,28,8,73.7,5,3
57,5,1,7,4,76.2,2,2
57,6,1,14,7,78.8,2,5
57,7,1,2,0,75.2,0,0
57,8,1,6,3,79.4,2,1
57,9,1,0,1,76.5,1,0
57,10,1,20,7,76.2,4,3
57,11,1,8,7,78.8,4,3
57,12,1,0,2,75.7,1,1
57,13,1,13,7,76.4,5,2
57,14,1,22,9,73.8,3,6
57,15,1,16,10,83.9,8,2
57,16,1,0,1,73.8,0,1
57,17,1,0,3,77.2,1,2
57,18,1,20,8,79.9,5,3
57,19,1,10,4,80.3,3,1
57,20,1,6,5,73.9,1,4
57,21,1,0,2,78.1,1,1
57,22,1,19,10,76.1,6,4
57,23,1,13,8,73.4,5,3
57,24,1,0,1,77.9,0,1
57,25,1,30,18,75.3,7,11
57,26,1,0,1,77.8,1,0
57,27,1,20,13,78.9,5,8
57,28,1,1,2,76.4,1,1
57,29,1,0,2,74.6,1,1
57,30,1,7,10,76.5,3,7
58,1,0,94,8,55.6,2,6
58,2,0,87,7,58.4,4,3
58,3,0,94,7,54.3,1,6
58,4,0,64,5,55.0,3,2
58,5,0,83,11,56.8,4,7
58,6,0,73,11,59.8,2,9
58,7,0,68,12,59.3,4,8
58,8,0,68,8,51.5,4,4
58,9,0,84,15,57.8,6,9
58,10,0,98,12,54.1,2,10
58,11,0,93,13,59.4,4,9
58,12,0,83,9,58.7,1,8
58,13,0,77,10,58.6,5,5
58,14,0,64,11,54.7,4,7
58,15,0,58,8,56.5,3,5
58,16,0,91,14,59.4,4,10
58,17,0,83,15,56.5,9,6
58,18,0,98,15,60.6,2,13
58,19,0,79,14,55.9,3,11
58,20,0,63,11,56.3,4,7
58,21,0,63,12,57.6,5,7
58,22,0,86,15,56.5,3,12
58,23,0,84,16,58.4,4,12
58,24,0,86,18,53.3,10,8
58,25,0,81,19,56.5,9,10
58,26,0,111,21,54.3,6,15
58,27,0,73,15,57.2,9,6
58,28,0,55,12,59.0,7,5
58,29,0,93,19,58.4,6,13
58,30,0,90,19,54.2,5,14
59,1,0,41,4,62.7,2,2
59,2,0,35,4,63.5,1,3
59,3,0,61,5,64.8,3,2
59,4,0,18,5,65.3,4,1
59,5,0,56,7,67.6,4,3
59,6,0,43,5,63.5,4,1
59,7,0,30,4,60.7,3,1
59,8,0,18,4,63.2,4,0
59,9,0,25,5,64.3,2,3
59,10,0,33,5,63.3,4,1
59,11,0,22,4,62.5,3,1
59,12,0,33,5,63.7,4,1
59,13,0,26,5,64.0,2,3
59,14,0,5,1,64.0,1,0
59,15,0,39,6,58.2,3,3
59,16,0,76,11,65.4,5,6
59,17,0,8,4,64.3,1,3
59,18,0,2,2,62.0,0,2
59,19,0,39,7,63.1,2,5
59,20,0,19,5,64.0,2,3
59,21,0,6,2,66.1,2,0
59,22,0,0,0,68.2,0,0
59,23,0,37,7,62.6,6,1
59,24,0,47,8,67.5,6,2
59,25,0,13,4,63.3,3,1
59,26,0,30,7,68.2,2,5
59,27,0,28,8,66.3,7,1
59,28,0,26,5,65.3,3,2
59,29,0,26,6,66.0,3,3
59,30,0,37,8,68.7,4,4
60,1,1,87,19,61.7,12,7
60,2,1,84,23,62.3,11,12
60,3,1,98,27,59.4,11,16
60,4,1,86,23,62.4,13,10
60,5,1,78,21,60.0,10,11
60,6,1,76,22,60.1,14,8
60,7,1,81,24,62.1,9,15
60,8,1,92,32,59.3,16,16
60,9,1,93,31,60.4,21,10
60,10,1,99,34,61.4,18,16
60,11,1,77,28,61.9,12,16
60,12,1,117,43,64.2,31,12
60,13,1,69,28,60.1,10,18
60,14,1,56,24,64.3,10,14
60,15,1,104,43,59.7,21,22
60,16,1,93,40,61.8,19,21
60,17,1,74,32,58.3,13,19
60,18,1,60,26,63.2,15,11
60,19,1,100,47,60.5,27,20
60,20,1,40,19,63.4,7,12
60,21,1,38,21,66.3,15,6
60,22,1,102,50,61.2,24,26
60,23,1,89,47,67.5,18,29
60,24,1,99,56,64.5,28,28
60,25,1,74,42,61.3,16,26
60,26,1,92,50,60.5,30,20
60,27,1,41,24,60.8,15,9
60,28,1,68,38,61.9,14,24
60,29,1,79,47,62.6,21,26
60,30,1,94,56,63.7,23,33
61,1,0,85,6,69.6,2,4
61,2,0,92,8,69.2,5,3
61,3,0,93,11,69.2,4,7
61,4,0,96,10,68.2,6,4
61,5,0,84,8,66.7,3,5
61,6,0,56,6,67.4,1,5
61,7,0,47,6,67.7,4,2
61,8,0,69,8,69.3,5,3
61,9,0,99,10,64.8,6,4
61,10,0,98,16,67.0,8,8
61,11,0,92,10,66.2,7,3
61,12,0,68,9,65.3,5,4
61,13,0,56,10,65.3,5,5
61,14,0,75,12,67.5,7,5
61,15,0,83,14,61.9,10,4
61,16,0,95,17,66.5,4,13
61,17,0,81,13,67.5,5,8
61,18,0,86,13,67.8,8,5
61,19,0,78,11,64.8,5,6
61,20,0,62,9,68.3,6,3
61,21,0,72,14,68.7,8,6
61,22,0,82,15,64.0,10,5
61,23,0,84,14,67.5,7,7
61,24,0,92,19,70.0,12,7
61,25,0,83,14,70.3,7,7
61,26,0,66,15,68.9,8,7
61,27,0,60,13,65.9,5,8
61,28,0,51,9,67.8,4,5
61,29,0,71,14,67.6,9,5
61,30,0,102,22,68.0,10,12
62,1,1,127,29,56.5,16,13
62,2,1,114,26,52.8,16,10
62,3,1,118,28,56.2,15,13
62,4,1,140,40,55.9,22,18
62,5,1,110,32,53.4,16,16
62,6,1,72,25,56.8,11,14
62,7,1,76,23,52.5,10,13
62,8,1,109,35,58.9,18,17
62,9,1,135,47,53.6,21,26
62,10,1,152,54,56.7,28,26
62,11,1,110,42,55.5,20,22
62,12,1,101,38,58.0,18,20
62,13,1,78,31,54.3,14,17
62,14,1,71,27,56.1,18,9
62,15,1,102,42,58.7,21,21
62,16,1,113,49,55.5,20,29
62,17,1,77,33,59.3,17,16
62,18,1,94,45,53.0,26,19
62,19,1,114,53,55.3,30,23
62,20,1,85,39,55.1,25,14
62,21,1,85,41,53.9,22,19
62,22,1,131,64,58.2,33,31
62,23,1,116,58,57.2,38,20
62,24,1,103,53,58.3,30,23
62,25,1,116,63,56.4,27,36
62,26,1,122,68,55.0,37,31
62,27,1,80,45,57.1,24,21
62,28,1,73,42,57.6,19,23
62,29,1,131,76,60.0,38,38
62,30,1,124,75,56.6,43,32
63,1,0,91,9,76.3,3,6
63,2,0,96,7,71.9,6,1
63,3,0,90,11,79.5,4,7
63,4,0,105,12,73.5,8,4
63,5,0,82,9,77.2,5,4
63,6,0,62,6,76.3,3,3
63,7,0,69,6,71.6,3,3
63,8,0,117,12,77.2,5,7
63,9,0,79,10,74.2,4,6
63,10,0,84,11,72.8,6,5
63,11,0,95,13,77.5,8,5
63,12,0,87,12,76.9,7,5
63,13,0,61,8,75.0,4,4
63,14,0,58,8,73.8,5,3
63,15,0,93,14,75.2,9,5
63,16,0,78,11,75.4,8,3
63,17,0,90,16,73.2,5,11
63,18,0,76,14,77.4,8,6
63,19,0,94,14,76.8,6,8
63,20,0,56,9,77.0,5,4
63,21,0,66,12,76.3,5,7
63,22,0,98,18,74.6,9,9
63,23,0,62,16,77.5,8,8
63,24,0,137,23,77.9,12,11
63,25,0,121,23,74.5,14,9
63,26,0,95,17,73.0,4,13
63,27,0,48,9,69.8,5,4
63,28,0,59,11,76.2,5,6
63,29,0,98,21,71.2,14,7
63,30,0,81,16,71.9,7,9
64,1,0,115,10,78.5,10,0
64,2,0,118,14,75.8,7,7
64,3,0,82,12,76.0,8,4
64,4,0,117,11,78.6,8,3
64,5,0,77,8,79.5,7,1
64,6,0,70,8,76.3,5,3
64,7,0,52,7,77.5,4,3
64,8,0,107,10,75.7,8,2
64,9,0,90,13,78.9,8,5
64,10,0,102,12,78.5,9,3
64,11,0,93,11,78.4,8,3
64,12,0,88,10,79.5,5,5
64,13,0,50,11,74.9,5,6
64,14,0,76,10,77.6,6,4
64,15,0,98,15,77.5,14,1
64,16,0,118,20,77.6,15,5
64,17,0,154,23,79.2,13,10
64,18,0,122,18,76.1,14,4
64,19,0,97,15,77.6,13,2
64,20,0,67,12,77.8,7,5
64,21,0,65,15,79.6,10,5
64,22,0,114,21,77.8,15,6
64,23,0,85,16,78.3,10,6
64,24,0,120,22,81.0,18,4
64,25,0,96,18,76.9,12,6
64,26,0,93,18,75.6,11,7
64,27,0,94,18,78.2,10,8
64,28,0,82,16,80.9,9,7
64,29,0,90,20,77.2,15,5
64,30,0,112,24,78.6,12,12
65,1,0,62,6,79.7,2,4
65,2,0,62,5,79.6,0,5
65,3,0,60,7,77.0,5,2
65,4,0,66,8,77.3,5,3
65,5,0,70,8,77.1,3,5
65,6,0,39,6,81.2,2,4
65,7,0,31,6,77.1,0,6
65,8,0,56,8,80.0,4,4
65,9,0,54,5,79.7,2,3
65,10,0,72,13,76.8,5,8
65,11,0,56,11,79.3,7,4
65,12,0,42,7,78.6,1,6
65,13,0,35,6,78.3,2,4
65,14,0,44,5,79.9,3,2
65,15,0,72,11,74.9,4,7
65,16,0,65,9,78.1,4,5
65,17,0,51,7,80.1,3,4
65,18,0,43,7,80.7,4,3
65,19,0,49,8,77.1,5,3
65,20,0,43,8,79.0,3,5
65,21,0,42,8,79.3,4,4
65,22,0,66,12,78.2,10,2
65,23,0,47,9,78.2,4,5
65,24,0,58,11,84.3,4,7
65,25,0,70,14,77.3,6,8
65,26,0,44,9,84.4,7,2
65,27,0,44,8,76.7,5,3
65,28,0,56,12,81.4,5,7
65,29,0,65,13,75.3,9,4
65,30,0,63,13,76.7,7,6
66,1,1,0,2,27.2,1,1
66,2,1,46,12,28.6,6,6
66,3,1,13,4,27.2,4,0
66,4,1,22,6,26.4,4,2
66,5,1,26,8,25.1,2,6
66,6,1,26,10,26.6,5,5
66,7,1,33,14,27.1,5,9
66,8,1,33,12,29.0,5,7
66,9,1,29,11,26.4,6,5
66,10,1,50,19,27.6,8,11
66,11,1,25,11,27.9,8,3
66,12,1,32,13,27.5,6,7
66,13,1,27,12,29.0,10,2
66,14,1,2,3,24.5,2,1
66,15,1,10,6,25.6,3,3
66,16,1,28,13,25.7,9,4
66,17,1,53,24,25.0,12,12
66,18,1,26,16,27.5,7,9
66,19,1,23,11,26.0,5,6
66,20,1,7,3,29.5,1,2
66,21,1,3,1,26.9,0,1
66,22,1,27,17,29.8,9,8
66,23,1,44,25,30.7,14,11
66,24,1,14,9,27.9,5,4
66,25,1,12,6,27.3,3,3
66,26,1,0,1,29.6,0,1
66,27,1,29,18,24.8,9,9
66,28,1,0,1,29.5,1,0
66,29,1,31,21,28.0,14,7
66,30,1,34,23,28.8,15,8
67,1,0,79,6,59.1,4,2
67,2,0,79,6,58.6,1,5
67,3,0,51,6,58.5,4,2
67,4,0,75,7,57.0,4,3
67,5,0,90,8,56.7,3,5
67,6,0,50,6,57.6,4,2
67,7,0,48,5,55.7,4,1
67,8,0,86,12,56.3,7,5
67,9,0,26,2,57.1,2,0
67,10,0,67,7,58.2,5,2
67,11,0,51,10,55.7,4,6
67,12,0,70,9,56.6,7,2
67,13,0,45,8,58.7,5,3
67,14,0,34,4,57.7,3,1
67,15,0,55,9,51.4,7,2
67,16,0,90,16,56.1,13,3
67,17,0,48,6,55.1,4,2
67,18,0,80,14,59.3,9,5
67,19,0,49,9,54.4,4,5
67,20,0,48,9,56.4,8,1
67,21,0,66,12,55.9,8,4
67,22,0,59,9,55.7,7,2
67,23,0,57,11,59.6,8,3
67,24,0,75,14,58.8,11,3
67,25,0,70,13,54.4,8,5
67,26,0,104,18,59.0,10,8
67,27,0,41,12,55.6,3,9
67,28,0,50,11,55.7,6,5
67,29,0,59,14,61.0,10,4
67,30,0,39,8,56.5,6,2
68,1,1,26,6,27.9,4,2
68,2,1,0,1,28.8,1,0
68,3,1,52,14,26.9,6,8
68,4,1,9,2,27.0,1,1
68,5,1,18,6,27.1,3,3
68,6,1,3,0,28.2,0,0
68,7,1,11,7,29.0,5,2
68,8,1,27,11,28.2,6,5
68,9,1,0,1,27.1,1,0
68,10,1,33,12,24.5,5,7
68,11,1,23,11,26.4,4,7
68,12,1,19,6,27.3,3,3
68,13,1,29,13,25.8,7,6
68,14,1,20,10,28.7,5,5
68,15,1,18,9,23.6,4,5
68,16,1,7,3,29.2,3,0
68,17,1,22,9,25.3,5,4
68,18,1,18,9,30.5,6,3
68,19,1,18,9,29.0,6,3
68,20,1,23,13,23.6,7,6
68,21,1,3,6,30.4,2,4
68,22,1,23,16,28.8,12,4
68,23,1,12,8,27.5,3,5
68,24,1,20,14,24.9,4,10
68,25,1,9,5,25.8,2,3
68,26,1,1,4,27.8,4,0
68,27,1,26,14,24.4,5,9
68,28,1,9,6,27.8,2,4
68,29,1,13,8,27.2,5,3
68,30,1,9,7,27.9,2,5
69,1,0,101,7,50.1,1,6
69,2,0,113,10,45.9,2,8
69,3,0,95,8,51.3,2,6
69,4,0,101,10,48.2,5,5
69,5,0,87,8,48.3,1,7
69,6,0,74,8,45.4,4,4
69,7,0,58,8,51.7,2,6
69,8,0,95,9,44.7,3,6
69,9,0,93,12,46.7,6,6
69,10,0,124,17,50.9,10,7
69,11,0,120,13,46.6,6,7
69,12,0,102,13,48.4,4,9
69,13,0,70,11,45.9,4,7
69,14,0,76,13,50.2,7,6
69,15,0,102,14,50.3,5,9
69,16,0,98,15,47.6,6,9
69,17,0,92,13,46.9,5,8
69,18,0,99,16,49.7,5,11
69,19,0,99,16,47.8,2,14
69,20,0,79,14,47.4,3,11
69,21,0,74,12,49.3,4,8
69,22,0,92,17,50.6,5,12
69,23,0,90,18,48.0,6,12
69,24,0,115,22,50.6,6,16
69,25,0,114,21,43.0,5,16
69,26,0,123,22,48.8,9,13
69,27,0,74,15,48.2,7,8
69,28,0,62,14,48.6,6,8
69,29,0,100,22,48.9,10,12
69,30,0,106,25,51.5,12,13
70,1,0,89,9,29.1,2,7
70,2,0,36,5,29.6,4,1
70,3,0,46,6,30.6,4,2
70,4,0,83,11,32.6,3,8
70,5,0,45,4,32.2,3,1
70,6,0,33,7,30.4,0,7
70,7,0,44,6,28.4,3,3
70,8,0,44,5,27.5,2,3
70,9,0,51,7,29.6,2,5
70,10,0,60,6,29.3,2,4
70,11,0,53,11,30.8,3,8
70,12,0,65,8,28.2,1,7
70,13,0,38,6,30.7,2,4
70,14,0,39,6,30.0,2,4
70,15,0,39,9,29.7,3,6
70,16,0,53,8,30.0,1,7
70,17,0,51,8,30.9,2,6
70,18,0,57,8,32.4,1,7
70,19,0,56,11,31.2,5,6
70,20,0,58,10,32.9,2,8
70,21,0,51,9,32.0,2,7
70,22,0,82,14,26.5,5,9
70,23,0,85,16,27.5,6,10
70,24,0,58,11,27.7,3,8
70,25,0,74,18,30.1,7,11
70,26,0,69,14,28.1,5,9
70,27,0,54,11,31.6,6,5
70,28,0,42,10,32.5,3,7
70,29,0,84,19,30.2,3,16
70,30,0,86,17,31.3,8,9
71,1,1,46,12,23.4,9,3
71,2,1,47,10,26.4,7,3
71,3,1,56,15,26.9,5,10
71,4,1,52,14,29.9,6,8
71,5,1,51,14,25.7,6,8
71,6,1,44,16,26.5,6,10
71,7,1,47,14,30.0,13,1
71,8,1,60,19,29.3,8,11
71,9,1,51,17,28.6,11,6
71,10,1,51,19,30.1,11,8
71,11,1,33,13,28.4,6,7
71,12,1,69,27,28.2,20,7
71,13,1,58,22,27.2,8,14
71,14,1,27,10,28.1,4,6
71,15,1,36,14,21.9,7,7
71,16,1,46,20,29.3,6,14
71,17,1,61,29,26.6,10,19
71,18,1,26,12,28.1,6,6
71,19,1,35,15,28.6,5,10
71,20,1,30,19,29.1,12,7
71,21,1,38,19,30.3,8,11
71,22,1,57,30,28.7,16,14
71,23,1,48,25,28.5,10,15
71,24,1,32,19,31.3,12,7
71,25,1,68,38,25.1,17,21
71,26,1,68,42,28.4,18,24
71,27,1,24,15,29.0,6,9
71,28,1,35,21,30.5,15,6
71,29,1,77,49,30.3,27,22
71,30,1,44,28,29.4,15,13
72,1,0,16,1,35.9,0,1
72,2,0,6,2,40.0,0,2
72,3,0,26,5,39.3,3,2
72,4,0,45,4,44.1,2,2
72,5,0,11,3,42.5,1,2
72,6,0,12,3,40.0,1,2
72,7,0,17,2,39.5,1,1
72,8,0,18,6,40.1,2,4
72,9,0,20,3,39.6,1,2
72,10,0,68,8,39.7,1,7
72,11,0,31,4,40.0,3,1
72,12,0,65,7,38.2,0,7
72,13,0,36,8,38.5,1,7
72,14,0,17,2,36.1,0,2
72,15,0,19,2,51.7,0,2
72,16,0,0,5,39.7,1,4
72,17,0,28,5,39.5,1,4
72,18,0,36,9,40.1,4,5
72,19,0,39,9,38.7,5,4
72,20,0,25,6,38.7,3,3
72,21,0,27,6,38.8,3,3
72,22,0,38,8,39.3,4,4
72,23,0,12,3,41.1,0,3
72,24,0,21,3,39.0,1,2
72,25,0,25,7,38.8,2,5
72,26,0,28,7,41.0,5,2
72,27,0,34,7,42.3,2,5
72,28,0,30,9,40.0,3,6
72,29,0,38,9,40.1,3,6
72,30,0,12,4,42.7,0,4
73,1,1,59,13,34.9,10,3
73,2,1,67,17,34.4,8,9
73,3,1,66,15,34.6,6,9
73,4,1,76,22,34.1,13,9
73,5,1,64,20,34.8,8,12
73,6,1,45,15,36.5,5,10
73,7,1,51,14,33.5,8,6
73,8,1,71,25,36.4,11,14
73,9,1,65,26,33.0,15,11
73,10,1,41,15,33.7,8,7
73,11,1,62,21,36.3,9,12
73,12,1,82,31,37.2,19,12
73,13,1,43,18,31.6,11,7
73,14,1,60,26,33.5,15,11
73,15,1,48,20,41.2,10,10
73,16,1,69,28,36.0,16,12
73,17,1,84,36,31.2,21,15
73,18,1,74,34,36.5,19,15
73,19,1,86,40,33.5,12,28
73,20,1,53,28,34.2,12,16
73,21,1,54,28,35.8,14,14
73,22,1,60,31,31.8,16,15
73,23,1,67,35,34.6,20,15
73,24,1,39,21,31.3,9,12
73,25,1,68,37,34.6,16,21
73,26,1,22,14,28.1,5,9
73,27,1,41,24,34.6,11,13
73,28,1,38,21,35.0,12,9
73,29,1,71,42,31.3,17,25
73,30,1,61,37,36.6,17,20
74,1,1,99,21,77.0,15,6
74,2,1,108,26,78.9,14,12
74,3,1,117,30,76.5,17,13
74,4,1,126,32,77.7,14,18
74,5,1,110,32,75.4,19,13
74,6,1,89,25,79.1,10,15
74,7,1,78,22,79.8,13,9
74,8,1,117,39,77.6,19,20
74,9,1,102,32,76.2,10,22
74,10,1,141,51,76.7,24,27
74,11,1,70,25,78.1,16,9
74,12,1,104,37,77.3,17,20
74,13,1,74,29,78.6,15,14
74,14,1,73,30,78.2,9,21
74,15,1,89,36,93.2,18,18
74,16,1,96,43,76.7,19,24
74,17,1,100,45,79.4,24,21
74,18,1,87,41,78.1,23,18
74,19,1,133,62,79.1,30,32
74,20,1,72,33,78.9,15,18
74,21,1,70,35,76.5,17,18
74,22,1,102,50,75.6,25,25
74,23,1,112,56,79.6,21,35
74,24,1,142,76,75.6,31,45
74,25,1,118,67,81.1,32,35
74,26,1,107,58,75.8,37,21
74,27,1,95,59,78.8,34,25
74,28,1,76,48,83.8,27,21
74,29,1,111,66,81.6,32,34
74,30,1,123,78,77.2,42,36
75,1,0,78,7,31.3,2,5
75,2,0,73,6,37.6,1,5
75,3,0,108,9,33.7,5,4
75,4,0,101,11,35.1,6,5
75,5,0,54,5,32.7,3,2
75,6,0,77,7,36.5,5,2
75,7,0,70,8,35.9,7,1
75,8,0,81,13,36.2,9,4
75,9,0,106,13,38.0,9,4
75,10,0,101,12,36.8,8,4
75,11,0,109,13,35.7,9,4
75,12,0,71,11,37.7,9,2
75,13,0,76,11,35.1,7,4
75,14,0,61,7,35.5,2,5
75,15,0,116,16,36.1,9,7
75,16,0,114,17,36.3,15,2
75,17,0,105,14,36.0,8,6
75,18,0,93,15,38.9,8,7
75,19,0,98,16,38.2,11,5
75,20,0,69,12,35.2,9,3
75,21,0,57,10,38.0,7,3
75,22,0,101,18,37.6,11,7
75,23,0,87,16,37.3,10,6
75,24,0,83,19,33.8,12,7
75,25,0,103,20,33.4,12,8
75,26,0,73,15,37.5,10,5
75,27,0,60,11,37.0,6,5
75,28,0,69,14,33.4,10,4
75,29,0,86,18,34.8,8,10
75,30,0,88,19,34.1,13,6
76,1,0,70,5,67.6,3,2
76,2,0,90,7,67.0,7,0
76,3,0,58,6,61.8,1,5
76,4,0,71,6,64.3,5,1
76,5,0,78,9,66.2,7,2
76,6,0,54,5,68.0,3,2
76,7,0,62,9,66.1,6,3
76,8,0,73,10,64.4,7,3
76,9,0,68,9,68.3,6,3
76,10,0,71,10,65.5,8,2
76,11,0,73,12,66.4,7,5
76,12,0,95,12,64.7,10,2
76,13,0,62,7,67.2,5,2
76,14,0,51,8,65.5,7,1
76,15,0,104,15,65.7,11,4
76,16,0,67,11,64.0,7,4
76,17,0,111,15,67.0,7,8
76,18,0,55,9,68.3,5,4
76,19,0,85,14,65.3,12,2
76,20,0,57,9,66.9,6,3
76,21,0,67,11,65.4,6,5
76,22,0,93,18,67.2,8,10
76,23,0,74,14,68.7,8,6
76,24,0,98,20,65.1,11,9
76,25,0,106,18,67.8,9,9
76,26,0,84,16,64.1,13,3
76,27,0,55,14,67.9,10,4
76,28,0,52,10,62.6,8,2
76,29,0,35,11,67.0,8,3
76,30,0,49,11,62.5,8,3
77,1,1,16,5,36.4,4,1
77,2,1,14,5,39.3,4,1
77,3,1,27,8,38.0,3,5
77,4,1,0,1,37.7,0,1
77,5,1,29,13,36.5,8,5
77,6,1,11,4,37.0,3,1
77,7,1,15,6,40.0,2,4
77,8,1,0,3,36.7,2,1
77,9,1,0,1,39.1,1,0
77,10,1,7,4,40.6,2,2
77,11,1,8,6,38.6,2,4
77,12,1,26,11,38.9,7,4
77,13,1,10,5,39.1,4,1
77,14,1,4,3,40.0,0,3
77,15,1,15,6,38.2,2,4
77,16,1,22,14,34.6,10,4
77,17,1,25,12,32.6,7,5
77,18,1,28,14,37.9,9,5
77,19,1,17,11,33.7,7,4
77,20,1,6,4,33.7,2,2
77,21,1,13,7,34.8,3,4
77,22,1,0,2,40.2,1,1
77,23,1,7,3,38.5,0,3
77,24,1,7,6,38.6,3,3
77,25,1,19,14,35.5,6,8
77,26,1,0,2,41.0,0,2
77,27,1,22,15,40.4,6,9
77,28,1,11,7,36.5,4,3
77,29,1,0,4,38.3,3,1
77,30,1,9,5,30.8,4,1
78,1,0,57,7,26.1,4,3
78,2,0,97,7,28.8,6,1
78,3,0,79,7,30.5,5,2
78,4,0,87,10,26.4,3,7
78,5,0,92,11,32.4,8,3
78,6,0,58,7,34.6,5,2
78,7,0,51,4,27.1,3,1
78,8,0,91,9,30.9,5,4
78,9,0,65,8,30.5,3,5
78,10,0,87,11,29.7,6,5
78,11,0,69,10,29.2,6,4
78,12,0,95,12,29.7,10,2
78,13,0,42,8,28.9,6,2
78,14,0,68,10,28.3,7,3
78,15,0,89,17,33.6,14,3
78,16,0,89,12,29.1,7,5
78,17,0,99,15,31.7,12,3
78,18,0,89,14,28.1,6,8
78,19,0,66,10,25.7,8,2
78,20,0,52,13,31.0,9,4
78,21,0,60,11,27.8,7,4
78,22,0,71,11,30.3,8,3
78,23,0,84,16,27.7,8,8
78,24,0,74,17,28.1,11,6
78,25,0,56,12,27.9,9,3
78,26,0,68,12,29.1,8,4
78,27,0,60,14,29.1,7,7
78,28,0,51,12,31.4,10,2
78,29,0,97,19,26.8,14,5
78,30,0,75,16,31.3,10,6
79,1,0,85,7,45.2,5,2
79,2,0,103,11,47.6,3,8
79,3,0,118,14,42.6,5,9
79,4,0,78,8,45.7,6,2
79,5,0,63,6,47.6,4,2
79,6,0,60,9,43.1,5,4
79,7,0,60,5,42.7,2,3
79,8,0,106,13,46.7,10,3
79,9,0,70,10,42.8,5,5
79,10,0,127,16,43.2,8,8
79,11,0,96,12,43.9,5,7
79,12,0,53,10,44.9,6,4
79,13,0,47,6,46.6,5,1
79,14,0,66,9,45.5,2,7
79,15,0,62,11,50.1,5,6
79,16,0,66,11,44.1,7,4
79,17,0,79,13,44.6,5,8
79,18,0,76,15,45.4,7,8
79,19,0,81,13,45.6,6,7
79,20,0,64,10,39.4,4,6
79,21,0,59,9,44.7,4,5
79,22,0,91,15,42.8,7,8
79,23,0,98,17,44.3,9,8
79,24,0,113,23,44.3,8,15
79,25,0,106,19,42.6,8,11
79,26,0,87,15,46.2,8,7
79,27,0,65,14,45.7,3,11
79,28,0,50,9,48.9,4,5
79,29,0,84,18,46.1,9,9
79,30,0,74,14,42.1,9,5
80,1,1,44,13,18.9,7,6
80,2,1,83,19,21.8,9,10
80,3,1,65,17,22.5,5,12
80,4,1,77,20,19.7,7,13
80,5,1,51,16,21.4,11,5
80,6,1,47,15,20.6,8,7
80,7,1,26,9,21.3,5,4
80,8,1,0,4,22.3,4,0
80,9,1,45,14,17.8,5,9
80,10,1,55,18,19.6,9,9
80,11,1,51,20,19.4,10,10
80,12,1,46,17,22.7,5,12
80,13,1,30,14,20.5,3,11
80,14,1,36,14,19.6,10,4
80,15,1,24,10,23.7,9,1
80,16,1,55,22,23.2,3,19
80,17,1,30,13,20.2,8,5
80,18,1,35,17,18.8,11,6
80,19,1,70,34,18.7,16,18
80,20,1,33,17,23.0,7,10
80,21,1,25,15,21.4,8,7
80,22,1,45,24,19.7,16,8
80,23,1,23,12,19.1,9,3
80,24,1,40,22,20.2,12,10
80,25,1,85,46,15.9,24,22
80,26,1,47,26,22.2,9,17
80,27,1,25,16,21.1,11,5
80,28,1,22,14,21.3,9,5
80,29,1,34,23,20.6,9,14
80,30,1,48,31,18.8,15,16
81,1,0,93,10,38.5,5,5
81,2,0,104,8,35.7,6,2
81,3,0,69,6,35.1,5,1
81,4,0,103,9,34.3,6,3
81,5,0,128,13,34.6,10,3
81,6,0,74,9,32.2,8,1
81,7,0,69,9,35.8,4,5
81,8,0,116,13,36.0,8,5
81,9,0,98,13,35.4,11,2
81,10,0,65,9,35.6,4,5
81,11,0,82,12,36.5,8,4
81,12,0,94,13,33.2,9,4
81,13,0,59,9,37.3,3,6
81,14,0,65,11,35.1,8,3
81,15,0,108,19,32.6,13,6
81,16,0,98,15,39.0,10,5
81,17,0,53,10,34.6,8,2
81,18,0,65,10,34.3,4,6
81,19,0,99,16,36.7,10,6
81,20,0,71,12,34.2,8,4
81,21,0,72,11,34.6,10,1
81,22,0,95,17,36.2,14,3
81,23,0,90,17,34.3,13,4
81,24,0,86,15,40.1,8,7
81,25,0,74,14,33.6,6,8
81,26,0,82,17,33.6,11,6
81,27,0,55,12,34.2,8,4
81,28,0,60,12,35.8,6,6
81,29,0,86,22,36.3,12,10
81,30,0,88,19,37.1,14,5
82,1,1,73,15,42.5,10,5
82,2,1,75,19,47.2,12,7
82,3,1,51,13,41.3,5,8
82,4,1,58,18,44.1,6,12
82,5,1,38,14,42.1,7,7
82,6,1,57,16,44.6,5,11
82,7,1,59,17,44.5,11,6
82,8,1,40,17,43.5,10,7
82,9,1,39,14,44.2,7,7
82,10,1,50,19,41.3,12,7
82,11,1,58,23,41.6,9,14
82,12,1,51,20,43.9,7,13
82,13,1,37,15,43.5,4,11
82,14,1,38,17,44.7,5,12
82,15,1,95,42,44.8,26,16
82,16,1,32,14,42.6,8,6
82,17,1,76,33,44.7,19,14
82,18,1,85,41,43.5,23,18
82,19,1,56,28,42.4,16,12
82,20,1,36,16,43.7,8,8
82,21,1,37,19,43.3,10,9
82,22,1,92,48,46.0,23,25
82,23,1,77,40,44.4,18,22
82,24,1,50,27,44.7,17,10
82,25,1,47,27,44.6,13,14
82,26,1,59,33,44.7,16,17
82,27,1,32,17,44.7,7,10
82,28,1,35,21,50.0,12,9
82,29,1,69,43,46.2,22,21
82,30,1,45,27,44.4,14,13
83,1,0,35,3,39.0,2,1
83,2,0,0,0,41.1,0,0
83,3,0,0,0,35.7,0,0
83,4,0,4,2,35.3,0,2
83,5,0,0,2,39.5,2,0
83,6,0,10,3,38.8,1,2
83,7,0,6,3,38.6,2,1
83,8,0,1,5,39.8,3,2
83,9,0,5,2,38.3,1,1
83,10,0,31,5,42.8,1,4
83,11,0,26,6,39.8,2,4
83,12,0,16,1,39.9,0,1
83,13,0,15,3,36.5,1,2
83,14,0,0,2,37.4,2,0
83,15,0,2,2,41.3,2,0
83,16,0,9,2,38.6,1,1
83,17,0,31,5,40.5,0,5
83,18,0,13,2,39.7,1,1
83,19,0,0,1,41.5,0,1
83,20,0,7,2,37.5,0,2
83,21,0,3,2,38.3,0,2
83,22,0,16,7,41.5,3,4
83,23,0,27,8,39.5,5,3
83,24,0,26,5,43.2,3,2
83,25,0,29,6,39.4,3,3
83,26,0,1,3,36.3,0,3
83,27,0,14,4,38.5,1,3
83,28,0,1,1,42.2,0,1
83,29,0,35,10,40.0,6,4
83,30,0,24,4,41.2,0,4
84,1,0,115,13,33.4,10,3
84,2,0,106,11,35.6,7,4
84,3,0,99,8,32.9,4,4
84,4,0,79,8,35.8,4,4
84,5,0,103,10,34.4,5,5
84,6,0,79,10,34.7,6,4
84,7,0,71,8,39.4,3,5
84,8,0,108,13,37.1,7,6
84,9,0,108,13,37.0,6,7
84,10,0,76,11,38.7,5,6
84,11,0,94,14,40.8,8,6
84,12,0,67,10,40.3,8,2
84,13,0,67,11,40.0,7,4
84,14,0,75,11,37.7,10,1
84,15,0,94,13,32.7,8,5
84,16,0,91,15,36.5,12,3
84,17,0,103,18,39.7,14,4
84,18,0,117,19,40.1,11,8
84,19,0,104,16,38.5,11,5
84,20,0,59,11,35.2,4,7
84,21,0,58,10,40.2,8,2
84,22,0,82,15,37.7,10,5
84,23,0,76,13,37.0,9,4
84,24,0,103,17,36.4,12,5
84,25,0,85,16,34.7,10,6
84,26,0,102,19,37.5,12,7
84,27,0,53,12,39.8,8,4
84,28,0,74,19,37.8,12,7
84,29,0,127,25,40.5,16,9
84,30,0,125,28,36.3,20,8
85,1,0,69,6,62.1,2,4
85,2,0,78,6,62.6,2,4
85,3,0,60,8,66.6,3,5
85,4,0,96,11,64.1,3,8
85,5,0,60,7,64.0,3,4
85,6,0,45,6,65.9,3,3
85,7,0,26,6,68.6,3,3
85,8,0,45,6,63.5,4,2
85,9,0,66,10,64.5,2,8
85,10,0,52,6,65.3,1,5
85,11,0,61,10,63.4,1,9
85,12,0,57,8,66.2,1,7
85,13,0,47,5,66.6,3,2
85,14,0,35,8,62.8,4,4
85,15,0,54,10,71.7,4,6
85,16,0,88,12,64.6,5,7
85,17,0,54,7,63.8,3,4
85,18,0,73,11,64.5,4,7
85,19,0,101,19,65.5,8,11
85,20,0,30,9,59.7,3,6
85,21,0,62,11,61.7,7,4
85,22,0,38,10,64.3,3,7
85,23,0,65,13,64.2,2,11
85,24,0,76,13,65.4,8,5
85,25,0,55,11,59.0,2,9
85,26,0,80,15,61.6,4,11
85,27,0,54,10,61.6,4,6
85,28,0,57,12,66.5,5,7
85,29,0,48,11,61.4,2,9
85,30,0,105,23,63.6,8,15
86,1,0,40,4,49.4,0,4
86,2,0,44,5,53.6,1,4
86,3,0,59,5,50.2,2,3
86,4,0,43,6,48.2,3,3
86,5,0,69,8,49.3,1,7
86,6,0,53,5,49.9,0,5
86,7,0,39,4,47.2,3,1
86,8,0,54,10,50.5,3,7
86,9,0,68,10,52.1,3,7
86,10,0,35,5,48.4,1,4
86,11,0,48,8,50.1,4,4
86,12,0,47,7,51.3,5,2
86,13,0,41,7,50.0,3,4
86,14,0,18,3,48.8,1,2
86,15,0,76,12,50.7,5,7
86,16,0,51,8,48.2,2,6
86,17,0,69,11,51.6,2,9
86,18,0,42,8,49.2,3,5
86,19,0,61,11,51.1,3,8
86,20,0,27,5,50.3,2,3
86,21,0,33,8,49.8,5,3
86,22,0,69,12,50.1,6,6
86,23,0,43,9,49.8,2,7
86,24,0,35,8,51.0,2,6
86,25,0,70,16,49.0,5,11
86,26,0,50,12,50.4,1,11
86,27,0,27,5,50.6,2,3
86,28,0,46,12,49.0,5,7
86,29,0,63,14,49.6,7,7
86,30,0,41,8,52.0,2,6
87,1,1,103,23,78.1,16,7
87,2,1,118,28,81.5,14,14
87,3,1,118,30,77.7,15,15
87,4,1,92,26,80.7,14,12
87,5,1,78,21,78.8,9,12
87,6,1,76,21,79.4,7,14
87,7,1,71,22,79.8,10,12
87,8,1,97,29,77.5,15,14
87,9,1,90,30,78.6,16,14
87,10,1,105,35,83.1,19,16
87,11,1,102,36,75.7,20,16
87,12,1,126,47,82.1,30,17
87,13,1,64,24,78.1,11,13
87,14,1,54,22,77.9,10,12
87,15,1,100,41,83.9,13,28
87,16,1,89,37,78.4,16,21
87,17,1,135,57,77.6,25,32
87,18,1,113,53,78.7,19,34
87,19,1,103,49,77.3,20,29
87,20,1,63,31,78.7,17,14
87,21,1,58,29,78.3,14,15
87,22,1,118,60,81.1,37,23
87,23,1,111,60,76.4,28,32
87,24,1,80,44,81.2,28,16
87,25,1,106,58,77.7,35,23
87,26,1,88,51,79.4,19,32
87,27,1,92,51,80.6,24,27
87,28,1,87,56,80.5,30,26
87,29,1,111,66,79.6,30,36
87,30,1,104,63,77.9,23,40
88,1,0,92,6,41.7,5,1
88,2,0,62,6,39.0,3,3
88,3,0,100,10,40.5,6,4
88,4,0,62,6,39.7,4,2
88,5,0,47,8,39.9,4,4
88,6,0,42,3,41.6,1,2
88,7,0,43,8,38.7,3,5
88,8,0,74,9,39.3,4,5
88,9,0,74,7,39.1,6,1
88,10,0,65,10,44.1,5,5
88,11,0,63,11,43.2,9,2
88,12,0,61,8,48.0,6,2
88,13,0,46,6,38.8,4,2
88,14,0,48,8,40.3,5,3
88,15,0,82,10,34.4,7,3
88,16,0,77,12,38.4,10,2
88,17,0,84,16,40.8,14,2
88,18,0,84,14,43.6,10,4
88,19,0,75,15,37.9,8,7
88,20,0,26,8,40.9,7,1
88,21,0,54,9,45.3,8,1
88,22,0,79,14,41.5,12,2
88,23,0,73,14,38.7,7,7
88,24,0,77,14,42.7,9,5
88,25,0,70,12,41.0,9,3
88,26,0,74,16,41.5,10,6
88,27,0,56,16,38.7,11,5
88,28,0,64,12,40.5,9,3
88,29,0,58,14,43.1,9,5
88,30,0,64,15,41.0,9,6
89,1,0,16,3,22.4,0,3
89,2,0,26,1,22.8,0,1
89,3,0,28,4,26.9,2,2
89,4,0,30,6,25.2,2,4
89,5,0,30,3,18.9,1,2
89,6,0,9,1,23.2,0,1
89,7,0,9,0,24.7,0,0
89,8,0,0,0,22.4,0,0
89,9,0,2,2,23.8,0,2
89,10,0,27,3,22.6,2,1
89,11,0,13,2,26.4,1,1
89,12,0,2,0,21.1,0,0
89,13,0,17,2,20.5,2,0
89,14,0,0,2,20.1,1,1
89,15,0,26,4,31.4,2,2
89,16,0,22,8,25.4,1,7
89,17,0,22,5,20.4,0,5
89,18,0,9,5,23.4,3,2
89,19,0,2,1,20.4,1,0
89,20,0,16,3,22.7,0,3
89,21,0,0,3,25.6,2,1
89,22,0,42,9,22.6,4,5
89,23,0,0,2,21.7,0,2
89,24,0,12,5,27.4,2,3
89,25,0,9,2,21.9,0,2
89,26,0,16,5,29.1,2,3
89,27,0,14,4,24.7,1,3
89,28,0,0,1,23.0,1,0
89,29,0,25,6,17.4,3,3
89,30,0,10,3,27.3,1,2
90,1,0,98,8,52.6,2,6
90,2,0,119,9,52.3,5,4
90,3,0,112,9,54.0,2,7
90,4,0,90,8,51.5,3,5
90,5,0,96,11,52.4,2,9
90,6,0,74,8,54.5,2,6
90,7,0,77,10,52.6,2,8
90,8,0,87,9,55.4,8,1
90,9,0,70,8,52.2,2,6
90,10,0,102,12,48.7,5,7
90,11,0,116,16,52.8,6,10
90,12,0,104,13,55.4,4,9
90,13,0,92,12,52.2,6,6
90,14,0,70,10,53.7,5,5
90,15,0,115,17,53.1,6,11
90,16,0,105,16,49.8,4,12
90,17,0,95,13,53.1,5,8
90,18,0,96,18,51.9,7,11
90,19,0,95,14,52.1,9,5
90,20,0,70,12,49.6,3,9
90,21,0,78,13,51.6,2,11
90,22,0,120,22,54.1,9,13
90,23,0,122,21,51.9,6,15
90,24,0,116,21,48.8,8,13
90,25,0,91,18,53.3,3,15
90,26,0,84,16,53.7,7,9
90,27,0,84,19,50.9,5,14
90,28,0,74,17,51.2,9,8
90,29,0,99,20,53.6,8,12
90,30,0,114,23,51.3,8,15
91,1,0,70,6,68.9,3,3
91,2,0,63,5,68.5,2,3
91,3,0,88,8,69.2,6,2
91,4,0,61,5,70.8,4,1
91,5,0,69,7,66.8,4,3
91,6,0,76,9,71.7,6,3
91,7,0,52,7,68.2,1,6
91,8,0,52,6,72.8,5,1
91,9,0,78,12,67.7,7,5
91,10,0,89,11,71.0,6,5
91,11,0,71,8,68.5,6,2
91,12,0,91,12,68.1,9,3
91,13,0,51,9,69.5,7,2
91,14,0,45,7,68.7,4,3
91,15,0,89,13,63.6,7,6
91,16,0,67,10,69.0,7,3
91,17,0,81,12,66.3,8,4
91,18,0,78,12,67.2,6,6
91,19,0,97,17,68.4,10,7
91,20,0,50,10,69.1,8,2
91,21,0,78,13,69.1,9,4
91,22,0,83,15,68.4,12,3
91,23,0,78,15,69.7,11,4
91,24,0,69,14,69.1,6,8
91,25,0,78,17,68.1,13,4
91,26,0,77,16,70.3,11,5
91,27,0,59,13,67.0,8,5
91,28,0,64,14,66.7,7,7
91,29,0,64,14,66.8,8,6
91,30,0,67,15,70.4,12,3
92,1,0,115,12,67.1,8,4
92,2,0,95,10,63.5,5,5
92,3,0,97,8,61.4,6,2
92,4,0,83,10,64.7,5,5
92,5,0,96,13,64.1,10,3
92,6,0,56,6,65.7,3,3
92,7,0,88,10,65.1,6,4
92,8,0,94,10,66.5,10,0
92,9,0,87,10,63.5,7,3
92,10,0,94,12,64.7,8,4
92,11,0,102,12,68.5,7,5
92,12,0,96,16,63.9,9,7
92,13,0,79,12,65.2,7,5
92,14,0,74,11,64.7,8,3
92,15,0,97,13,70.9,7,6
92,16,0,59,9,65.7,7,2
92,17,0,99,15,62.5,7,8
92,18,0,75,15,65.2,10,5
92,19,0,94,16,63.4,10,6
92,20,0,54,9,67.8,7,2
92,21,0,57,11,67.5,8,3
92,22,0,99,18,66.3,13,5
92,23,0,94,19,66.9,11,8
92,24,0,80,17,62.9,10,7
92,25,0,86,16,67.6,11,5
92,26,0,84,18,64.8,11,7
92,27,0,63,14,67.8,10,4
92,28,0,60,14,69.6,4,10
92,29,0,120,24,65.4,11,13
92,30,0,110,23,67.6,14,9
93,1,1,122,29,19.4,17,12
93,2,1,124,35,23.7,25,10
93,3,1,110,28,21.1,14,14
93,4,1,88,26,24.7,20,6
93,5,1,109,30,22.7,19,11
93,6,1,75,22,20.3,13,9
93,7,1,90,28,21.0,14,14
93,8,1,109,34,22.5,16,18
93,9,1,101,34,20.0,18,16
93,10,1,109,39,20.4,16,23
93,11,1,110,39,21.2,21,18
93,12,1,116,42,21.7,22,20
93,13,1,96,36,23.9,19,17
93,14,1,76,32,22.5,15,17
93,15,1,125,54,25.1,25,29
93,16,1,106,46,20.3,22,24
93,17,1,136,59,23.6,30,29
93,18,1,103,45,24.6,25,20
93,19,1,118,57,20.6,32,25
93,20,1,75,37,17.7,17,20
93,21,1,100,48,19.6,26,22
93,22,1,120,62,15.8,28,34
93,23,1,110,58,22.2,23,35
93,24,1,130,68,21.7,40,28
93,25,1,122,65,17.3,30,35
93,26,1,113,61,20.7,29,32
93,27,1,76,43,21.9,18,25
93,28,1,86,51,19.9,19,32
93,29,1,117,72,19.4,34,38
93,30,1,125,79,22.6,36,43
94,1,0,106,8,38.7,5,3
94,2,0,70,6,40.9,3,3
94,3,0,120,11,42.5,7,4
94,4,0,101,9,45.4,4,5
94,5,0,111,10,36.4,6,4
94,6,0,90,10,43.3,6,4
94,7,0,68,9,40.8,5,4
94,8,0,105,11,41.6,5,6
94,9,0,66,9,41.1,6,3
94,10,0,102,14,45.2,11,3
94,11,0,141,17,44.4,11,6
94,12,0,103,14,45.2,7,7
94,13,0,77,10,42.4,8,2
94,14,0,69,10,43.9,3,7
94,15,0,64,12,45.2,4,8
94,16,0,99,14,42.9,7,7
94,17,0,114,19,43.9,5,14
94,18,0,69,14,43.1,9,5
94,19,0,117,18,41.2,11,7
94,20,0,86,13,43.4,8,5
94,21,0,57,9,39.4,3,6
94,22,0,118,22,42.2,7,15
94,23,0,102,21,41.8,13,8
94,24,0,106,20,37.8,6,14
94,25,0,89,17,42.9,7,10
94,26,0,104,18,41.8,9,9
94,27,0,80,15,40.6,9,6
94,28,0,57,16,42.0,8,8
94,29,0,117,24,42.5,9,15
94,30,0,110,26,45.4,13,13
95,1,0,51,7,30.4,4,3
95,2,0,102,10,29.5,6,4
95,3,0,63,9,30.1,5,4
95,4,0,70,6,30.7,4,2
95,5,0,95,10,28.7,3,7
95,6,0,44,5,29.6,3,2
95,7,0,58,5,27.2,4,1
95,8,0,79,9,32.7,6,3
95,9,0,76,11,28.7,5,6
95,10,0,30,4,30.7,3,1
95,11,0,87,11,25.9,6,5
95,12,0,92,13,33.8,8,5
95,13,0,51,7,27.9,2,5
95,14,0,38,7,32.7,4,3
95,15,0,61,11,27.7,5,6
95,16,0,74,12,32.7,9,3
95,17,0,66,12,25.7,5,7
95,18,0,47,9,33.6,4,5
95,19,0,81,16,32.5,8,8
95,20,0,58,10,32.0,5,5
95,21,0,38,8,28.8,4,4
95,22,0,83,17,30.2,8,9
95,23,0,78,14,31.1,4,10
95,24,0,111,20,33.0,13,7
95,25,0,87,15,31.3,8,7
95,26,0,68,13,36.3,8,5
95,27,0,40,9,26.1,8,1
95,28,0,55,14,34.1,8,6
95,29,0,68,15,26.5,10,5
95,30,0,70,16,31.4,4,12
96,1,0,86,8,50.0,6,2
96,2,0,108,11,49.0,5,6
96,3,0,68,9,45.7,3,6
96,4,0,75,7,47.7,5,2
96,5,0,94,10,46.9,6,4
96,6,0,67,9,47.4,5,4
96,7,0,68,10,49.6,5,5
96,8,0,70,11,48.6,3,8
96,9,0,96,10,47.3,6,4
96,10,0,87,12,47.3,9,3
96,11,0,94,11,50.1,8,3
96,12,0,108,14,51.8,6,8
96,13,0,61,11,46.9,7,4
96,14,0,57,10,47.8,6,4
96,15,0,96,21,56.5,13,8
96,16,0,57,8,48.4,4,4
96,17,0,55,11,46.2,7,4
96,18,0,72,12,51.6,5,7
96,19,0,83,16,48.4,5,11
96,20,0,59,12,48.7,6,6
96,21,0,78,16,47.7,8,8
96,22,0,67,11,48.2,6,5
96,23,0,73,12,45.9,8,4
96,24,0,101,19,49.6,11,8
96,25,0,65,16,49.1,7,9
96,26,0,70,14,44.5,5,9
96,27,0,57,11,49.5,5,6
96,28,0,50,10,51.5,6,4
96,29,0,89,20,50.3,9,11
96,30,0,86,18,48.8,9,9
97,1,0,2,5,47.3,2,3
97,2,0,34,4,47.0,3,1
97,3,0,0,1,47.8,0,1
97,4,0,13,3,42.7,0,3
97,5,0,41,5,49.7,3,2
97,6,0,13,1,48.9,0,1
97,7,0,18,1,47.2,1,0
97,8,0,29,5,50.3,4,1
97,9,0,27,4,40.8,0,4
97,10,0,0,2,46.4,0,2
97,11,0,0,3,48.6,1,2
97,12,0,11,2,48.2,0,2
97,13,0,5,1,44.3,0,1
97,14,0,0,1,49.1,1,0
97,15,0,38,6,42.8,2,4
97,16,0,32,5,44.2,2,3
97,17,0,16,3,44.5,1,2
97,18,0,12,7,45.8,1,6
97,19,0,13,2,47.4,1,1
97,20,0,13,2,49.8,0,2
97,21,0,0,3,41.9,0,3
97,22,0,24,5,42.6,0,5
97,23,0,29,7,49.6,2,5
97,24,0,2,2,44.9,1,1
97,25,0,20,3,47.7,2,1
97,26,0,38,8,50.6,4,4
97,27,0,7,4,47.1,1,3
97,28,0,29,7,46.8,3,4
97,29,0,0,4,44.1,2,2
97,30,0,32,8,47.2,4,4
98,1,1,20,5,60.9,2,3
98,2,1,10,3,62.8,2,1
98,3,1,24,6,65.0,2,4
98,4,1,33,10,61.9,4,6
98,5,1,3,1,65.8,1,0
98,6,1,29,11,63.4,6,5
98,7,1,25,10,62.8,2,8
98,8,1,0,0,64.1,0,0
98,9,1,17,6,65.5,3,3
98,10,1,4,2,64.9,1,1
98,11,1,11,3,64.7,0,3
98,12,1,5,4,67.2,1,3
98,13,1,30,14,60.8,7,7
98,14,1,1,3,61.1,0,3
98,15,1,35,14,63.1,9,5
98,16,1,11,9,65.7,7,2
98,17,1,47,22,63.9,14,8
98,18,1,16,9,66.3,5,4
98,19,1,14,9,65.0,5,4
98,20,1,0,1,64.9,1,0
98,21,1,24,13,64.1,5,8
98,22,1,48,25,64.2,16,9
98,23,1,50,28,61.9,15,13
98,24,1,14,8,63.9,6,2
98,25,1,15,9,62.2,4,5
98,26,1,44,26,62.5,14,12
98,27,1,14,10,60.2,4,6
98,28,1,21,13,63.8,10,3
98,29,1,32,20,64.4,13,7
98,30,1,8,8,62.8,5,3
99,1,1,72,16,74.9,8,8
99,2,1,41,9,72.7,4,5
99,3,1,50,13,74.2,6,7
99,4,1,45,15,74.4,9,6
99,5,1,35,11,75.2,6,5
99,6,1,57,16,76.6,10,6
99,7,1,48,17,77.5,12,5
99,8,1,59,20,74.4,5,15
99,9,1,47,18,71.5,11,7
99,10,1,49,16,70.9,12,4
99,11,1,62,21,78.7,9,12
99,12,1,43,16,72.1,6,10
99,13,1,34,15,69.4,7,8
99,14,1,31,13,73.3,4,9
99,15,1,50,22,66.7,12,10
99,16,1,42,20,72.5,10,10
99,17,1,33,14,74.3,8,6
99,18,1,50,24,75.4,11,13
99,19,1,55,27,72.1,14,13
99,20,1,20,11,76.0,3,8
99,21,1,33,17,73.0,5,12
99,22,1,37,20,75.1,12,8
99,23,1,49,25,75.9,12,13
99,24,1,73,42,73.9,16,26
99,25,1,41,24,72.2,14,10
99,26,1,62,33,75.8,12,21
99,27,1,49,29,73.3,16,13
99,28,1,36,22,74.7,14,8
99,29,1,67,41,71.5,18,23
99,30,1,35,29,75.9,17,12
100,1,1,78,17,48.8,11,6
100,2,1,78,18,49.5,7,11
100,3,1,49,13,45.6,6,7
100,4,1,88,23,45.4,14,9
100,5,1,82,22,44.7,15,7
100,6,1,60,17,45.3,7,10
100,7,1,37,13,48.8,6,7
100,8,1,76,25,47.2,15,10
100,9,1,71,24,47.3,12,12
100,10,1,83,27,42.8,11,16
100,11,1,58,24,46.5,11,13
100,12,1,76,30,44.8,22,8
100,13,1,59,23,43.3,10,13
100,14,1,63,26,43.7,8,18
100,15,1,62,28,52.0,13,15
100,16,1,91,38,45.6,22,16
100,17,1,79,34,45.0,21,13
100,18,1,82,37,42.8,22,15
100,19,1,92,42,48.9,28,14
100,20,1,58,29,45.0,21,8
100,21,1,60,29,44.5,17,12
100,22,1,67,37,48.7,21,16
100,23,1,53,28,52.1,19,9
100,24,1,104,55,44.9,30,25
100,25,1,94,52,45.6,24,28
100,26,1,59,32,45.1,13,19
100,27,1,51,31,46.7,21,10
100,28,1,66,40,48.6,25,15
100,29,1,104,63,48.6,40,23
100,30,1,95,61,43.8,22,39
101,1,1,64,13,38.0,10,3
101,2,1,41,12,38.8,8,4
101,3,1,67,18,38.8,10,8
101,4,1,61,16,37.2,5,11
101,5,1,91,25,40.9,19,6
101,6,1,51,17,39.0,7,10
101,7,1,49,18,39.4,9,9
101,8,1,79,27,33.9,6,21
101,9,1,42,15,40.1,7,8
101,10,1,35,11,35.8,3,8
101,11,1,50,20,36.8,8,12
101,12,1,55,23,37.6,11,12
101,13,1,44,19,38.1,9,10
101,14,1,49,19,34.6,9,10
101,15,1,64,28,34.9,12,16
101,16,1,37,17,37.8,12,5
101,17,1,75,33,38.2,12,21
101,18,1,50,24,37.2,12,12
101,19,1,71,34,33.7,15,19
101,20,1,57,29,39.7,17,12
101,21,1,40,20,35.0,9,11
101,22,1,54,27,36.3,10,17
101,23,1,59,31,35.6,17,14
101,24,1,65,33,38.4,19,14
101,25,1,70,40,38.8,22,18
101,26,1,53,32,39.8,24,8
101,27,1,48,28,38.6,15,13
101,28,1,30,22,36.3,8,14
101,29,1,66,40,36.7,20,20
101,30,1,63,40,39.6,22,18
102,1,1,36,10,41.7,7,3
102,2,1,18,5,40.5,4,1
102,3,1,29,10,40.9,4,6
102,4,1,18,7,40.1,2,5
102,5,1,35,10,39.3,8,2
102,6,1,4,2,40.1,0,2
102,7,1,25,8,41.8,3,5
102,8,1,30,10,38.9,4,6
102,9,1,5,5,40.0,4,1
102,10,1,36,13,38.7,7,6
102,11,1,11,5,43.3,2,3
102,12,1,30,12,39.9,3,9
102,13,1,28,12,37.8,8,4
102,14,1,0,3,35.8,2,1
102,15,1,31,14,33.4,11,3
102,16,1,0,1,37.5,0,1
102,17,1,48,22,37.5,13,9
102,18,1,14,7,36.6,4,3
102,19,1,32,14,37.0,6,8
102,20,1,13,6,40.1,2,4
102,21,1,0,1,43.0,1,0
102,22,1,29,15,40.5,6,9
102,23,1,20,10,40.1,6,4
102,24,1,10,9,40.7,3,6
102,25,1,13,8,38.7,4,4
102,26,1,0,0,37.6,0,0
102,27,1,7,6,43.1,2,4
102,28,1,21,13,40.3,5,8
102,29,1,11,9,38.7,6,3
102,30,1,22,13,37.8,5,8
103,1,0,97,8,65.4,7,1
103,2,0,101,9,66.7,5,4
103,3,0,109,12,65.8,6,6
103,4,0,105,8,65.4,5,3
103,5,0,69,7,69.7,5,2
103,6,0,63,6,69.1,1,5
103,7,0,64,9,70.9,2,7
103,8,0,93,11,70.1,7,4
103,9,0,107,13,65.7,8,5
103,10,0,115,13,66.7,8,5
103,11,0,113,14,67.8,8,6
103,12,0,132,18,66.5,4,14
103,13,0,74,13,69.3,9,4
103,14,0,77,11,66.3,5,6
103,15,0,97,14,65.5,6,8
103,16,0,103,16,70.0,5,11
103,17,0,72,12,66.9,7,5
103,18,0,107,16,69.0,8,8
103,19,0,117,18,65.4,8,10
103,20,0,62,11,64.9,5,6
103,21,0,87,16,66.5,5,11
103,22,0,125,24,69.8,17,7
103,23,0,99,17,67.5,9,8
103,24,0,123,22,70.1,15,7
103,25,0,98,18,62.4,10,8
103,26,0,110,22,67.5,10,12
103,27,0,77,16,68.8,5,11
103,28,0,69,13,66.3,4,9
103,29,0,84,18,69.3,6,12
103,30,0,115,24,71.1,11,13
104,1,0,2,3,70.8,3,0
104,2,0,20,3,62.5,3,0
104,3,0,18,1,63.2,0,1
104,4,0,15,1,67.1,0,1
104,5,0,3,0,66.2,0,0
104,6,0,0,0,65.3,0,0
104,7,0,28,4,63.2,3,1
104,8,0,4,1,65.4,1,0
104,9,0,22,2,61.3,1,1
104,10,0,15,2,67.5,2,0
104,11,0,52,9,63.2,6,3
104,12,0,8,4,65.4,0,4
104,13,0,9,5,65.1,4,1
104,14,0,15,3,66.9,1,2
104,15,0,20,4,58.2,3,1
104,16,0,26,4,63.1,3,1
104,17,0,0,2,63.5,1,1
104,18,0,34,5,68.5,3,2
104,19,0,20,5,69.0,3,2
104,20,0,14,3,66.0,2,1
104,21,0,6,2,61.0,2,0
104,22,0,0,2,65.2,1,1
104,23,0,18,8,67.1,6,2
104,24,0,46,11,63.2,7,4
104,25,0,23,7,67.4,7,0
104,26,0,1,1,64.0,1,0
104,27,0,0,1,64.7,1,0
104,28,0,23,6,64.9,3,3
104,29,0,12,6,62.9,4,2
104,30,0,16,5,63.0,2,3
105,1,0,108,10,76.5,6,4
105,2,0,60,5,77.9,5,0
105,3,0,103,9,79.5,6,3
105,4,0,78,9,79.2,8,1
105,5,0,87,8,73.9,7,1
105,6,0,72,7,78.5,5,2
105,7,0,63,9,79.1,7,2
105,8,0,103,13,77.9,8,5
105,9,0,103,12,77.9,9,3
105,10,0,107,14,74.4,10,4
105,11,0,94,10,74.6,7,3
105,12,0,108,13,70.9,8,5
105,13,0,54,7,75.3,4,3
105,14,0,72,11,78.9,9,2
105,15,0,106,16,84.8,11,5
105,16,0,85,12,78.1,9,3
105,17,0,66,10,75.5,7,3
105,18,0,73,11,77.0,6,5
105,19,0,76,13,77.5,8,5
105,20,0,71,12,76.2,7,5
105,21,0,49,9,78.2,5,4
105,22,0,87,19,79.8,16,3
105,23,0,80,14,80.8,10,4
105,24,0,87,17,78.0,12,5
105,25,0,81,15,75.2,7,8
105,26,0,75,14,81.2,6,8
105,27,0,70,15,78.4,10,5
105,28,0,53,11,79.4,7,4
105,29,0,96,22,76.4,15,7
105,30,0,80,16,78.0,13,3
106,1,0,35,6,71.8,5,1
106,2,0,61,6,70.7,2,4
106,3,0,47,3,70.8,2,1
106,4,0,52,7,70.7,7,0
106,5,0,54,5,71.9,2,3
106,6,0,33,6,67.7,3,3
106,7,0,30,2,69.7,1,1
106,8,0,58,5,72.5,4,1
106,9,0,63,8,69.0,6,2
106,10,0,32,8,70.1,5,3
106,11,0,64,10,67.3,7,3
106,12,0,87,12,71.7,6,6
106,13,0,34,6,72.7,4,2
106,14,0,16,5,69.5,5,0
106,15,0,65,11,77.6,5,6
106,16,0,19,5,72.7,3,2
106,17,0,28,4,72.0,3,1
106,18,0,52,10,73.1,6,4
106,19,0,50,8,68.0,6,2
106,20,0,16,3,70.9,2,1
106,21,0,21,3,70.5,2,1
106,22,0,36,8,71.8,4,4
106,23,0,65,11,75.0,8,3
106,24,0,31,7,68.7,4,3
106,25,0,26,5,74.9,3,2
106,26,0,20,3,71.2,1,2
106,27,0,42,11,72.1,8,3
106,28,0,26,6,70.6,6,0
106,29,0,68,13,69.1,8,5
106,30,0,30,8,71.1,6,2
107,1,1,109,24,20.7,13,11
107,2,1,146,33,20.5,15,18
107,3,1,114,29,19.2,17,12
107,4,1,114,29,21.4,17,12
107,5,1,104,29,21.0,16,13
107,6,1,82,24,23.5,15,9
107,7,1,75,23,19.5,4,19
107,8,1,102,33,19.7,12,21
107,9,1,99,35,17.4,10,25
107,10,1,133,44,17.9,22,22
107,11,1,116,45,18.2,25,20
107,12,1,120,46,21.0,21,25
107,13,1,93,37,22.8,20,17
107,14,1,81,31,24.5,16,15
107,15,1,115,48,25.8,24,24
107,16,1,124,54,22.3,28,26
107,17,1,122,54,19.8,30,24
107,18,1,127,55,19.3,18,37
107,19,1,88,41,19.3,19,22
107,20,1,87,42,21.4,18,24
107,21,1,81,40,19.1,16,24
107,22,1,104,52,21.4,26,26
107,23,1,93,51,19.6,24,27
107,24,1,101,53,23.8,30,23
107,25,1,129,69,18.8,35,34
107,26,1,132,73,19.4,31,42
107,27,1,88,52,19.0,23,29
107,28,1,91,54,21.5,30,24
107,29,1,112,67,21.8,29,38
107,30,1,105,66,21.3,34,32
108,1,0,38,5,75.2,3,2
108,2,0,45,5,66.5,2,3
108,3,0,41,6,71.2,3,3
108,4,0,77,12,74.8,5,7
108,5,0,28,4,69.7,1,3
108,6,0,22,4,73.8,1,3
108,7,0,30,6,72.6,6,0
108,8,0,45,8,74.6,7,1
108,9,0,22,4,71.3,3,1
108,10,0,29,4,73.8,3,1
108,11,0,60,9,76.7,7,2
108,12,0,45,5,71.6,4,1
108,13,0,16,3,75.0,3,0
108,14,0,25,5,74.5,3,2
108,15,0,62,11,76.5,9,2
108,16,0,58,8,70.9,4,4
108,17,0,6,1,72.9,1,0
108,18,0,43,8,71.3,2,6
108,19,0,24,6,74.3,3,3
108,20,0,10,2,74.0,1,1
108,21,0,26,6,69.8,6,0
108,22,0,11,1,74.9,1,0
108,23,0,0,1,71.0,0,1
108,24,0,67,11,77.6,9,2
108,25,0,24,5,74.0,3,2
108,26,0,62,13,72.4,10,3
108,27,0,32,7,70.8,3,4
108,28,0,24,7,71.4,6,1
108,29,0,26,9,72.9,5,4
108,30,0,35,9,69.6,3,6
109,1,0,42,4,52.8,2,2
109,2,0,42,6,54.2,0,6
109,3,0,64,8,51.9,4,4
109,4,0,43,6,51.7,2,4
109,5,0,64,8,52.5,2,6
109,6,0,25,2,52.2,0,2
109,7,0,42,8,53.8,3,5
109,8,0,39,5,48.9,1,4
109,9,0,37,6,54.7,3,3
109,10,0,50,7,50.8,3,4
109,11,0,79,9,52.9,6,3
109,12,0,40,5,52.7,3,2
109,13,0,20,7,49.0,2,5
109,14,0,3,2,53.2,0,2
109,15,0,45,6,55.8,1,5
109,16,0,49,7,51.4,4,3
109,17,0,21,3,49.1,0,3
109,18,0,25,4,54.6,1,3
109,19,0,35,7,53.6,3,4
109,20,0,24,8,52.5,3,5
109,21,0,17,4,51.9,2,2
109,22,0,67,13,51.1,3,10
109,23,0,65,16,51.3,2,14
109,24,0,34,7,52.2,1,6
109,25,0,47,10,52.9,4,6
109,26,0,58,13,52.9,6,7
109,27,0,31,7,49.6,2,5
109,28,0,46,9,50.7,2,7
109,29,0,62,14,50.5,6,8
109,30,0,14,3,51.6,1,2
110,1,0,46,6,47.1,3,3
110,2,0,54,5,50.2,5,0
110,3,0,35,5,50.2,2,3
110,4,0,54,4,47.2,3,1
110,5,0,46,4,51.5,3,1
110,6,0,32,5,51.1,2,3
110,7,0,45,6,50.4,6,0
110,8,0,41,5,47.3,3,2
110,9,0,53,6,48.5,3,3
110,10,0,30,3,50.7,3,0
110,11,0,40,7,48.0,4,3
110,12,0,55,7,49.1,3,4
110,13,0,23,3,50.7,1,2
110,14,0,40,7,49.3,4,3
110,15,0,33,6,48.9,4,2
110,16,0,49,8,51.8,6,2
110,17,0,24,5,48.0,1,4
110,18,0,45,7,47.0,4,3
110,19,0,57,9,50.5,6,3
110,20,0,22,3,47.8,2,1
110,21,0,33,7,50.0,4,3
110,22,0,17,3,46.8,3,0
110,23,0,44,10,53.2,8,2
110,24,0,61,14,50.8,11,3
110,25,0,41,10,51.9,6,4
110,26,0,34,13,50.4,11,2
110,27,0,39,7,52.1,5,2
110,28,0,16,3,48.6,2,1
110,29,0,31,8,50.7,7,1
110,30,0,35,11,48.1,7,4
111,1,0,46,5,55.8,2,3
111,2,0,50,5,52.4,1,4
111,3,0,44,6,54.2,6,0
111,4,0,44,4,52.6,2,2
111,5,0,47,8,58.2,3,5
111,6,0,40,5,55.9,4,1
111,7,0,47,4,56.9,2,2
111,8,0,56,5,54.7,5,0
111,9,0,59,7,52.8,2,5
111,10,0,78,10,54.1,5,5
111,11,0,70,8,51.9,2,6
111,12,0,75,10,56.8,7,3
111,13,0,56,11,57.8,7,4
111,14,0,50,6,52.0,3,3
111,15,0,53,11,50.7,3,8
111,16,0,86,13,51.7,8,5
111,17,0,56,8,56.6,4,4
111,18,0,83,14,59.0,8,6
111,19,0,102,17,56.3,5,12
111,20,0,56,10,58.0,8,2
111,21,0,36,9,52.5,7,2
111,22,0,63,11,56.2,8,3
111,23,0,66,15,53.7,11,4
111,24,0,67,12,57.1,5,7
111,25,0,80,16,48.4,13,3
111,26,0,58,11,54.0,7,4
111,27,0,46,15,53.5,7,8
111,28,0,62,14,54.2,7,7
111,29,0,109,24,54.7,11,13
111,30,0,93,18,50.7,7,11
112,1,0,76,5,54.0,4,1
112,2,0,55,7,50.4,6,1
112,3,0,75,9,51.6,8,1
112,4,0,64,7,57.0,6,1
112,5,0,55,4,54.8,2,2
112,6,0,48,9,55.8,4,5
112,7,0,43,6,51.9,5,1
112,8,0,54,8,54.5,7,1
112,9,0,73,10,52.6,4,6
112,10,0,71,8,57.5,8,0
112,11,0,36,7,53.0,7,0
112,12,0,76,10,57.5,2,8
112,13,0,38,5,53.9,3,2
112,14,0,57,9,58.3,8,1
112,15,0,57,10,45.4,7,3
112,16,0,66,11,52.5,9,2
112,17,0,63,11,53.9,7,4
112,18,0,71,11,62.0,6,5
112,19,0,82,13,55.4,11,2
112,20,0,26,6,54.6,5,1
112,21,0,11,4,55.2,2,2
112,22,0,27,6,57.1,3,3
112,23,0,64,11,54.6,6,5
112,24,0,72,15,54.3,11,4
112,25,0,85,15,53.3,9,6
112,26,0,66,13,53.5,9,4
112,27,0,44,10,57.1,8,2
112,28,0,37,8,52.9,5,3
112,29,0,63,15,57.2,11,4
112,30,0,58,14,56.8,12,2
113,1,1,19,7,38.3,4,3
113,2,1,7,8,36.5,2,6
113,3,1,18,7,36.7,2,5
113,4,1,2,2,40.8,0,2
113,5,1,17,7,42.5,3,4
113,6,1,24,6,37.2,5,1
113,7,1,3,2,37.2,1,1
113,8,1,24,7,40.5,4,3
113,9,1,35,12,36.6,6,6
113,10,1,5,3,41.6,1,2
113,11,1,9,5,36.4,1,4
113,12,1,10,5,39.1,2,3
113,13,1,22,8,39.2,5,3
113,14,1,8,8,34.5,3,5
113,15,1,0,1,24.7,1,0
113,16,1,31,13,36.9,2,11
113,17,1,27,12,40.2,1,11
113,18,1,22,10,37.5,6,4
113,19,1,50,29,34.8,13,16
113,20,1,19,10,34.7,2,8
113,21,1,35,20,38.4,8,12
113,22,1,28,15,38.5,7,8
113,23,1,32,17,39.6,9,8
113,24,1,38,20,40.2,12,8
113,25,1,0,5,42.8,4,1
113,26,1,41,23,39.0,13,10
113,27,1,2,3,42.1,2,1
113,28,1,21,13,38.1,5,8
113,29,1,24,16,40.1,7,9
113,30,1,24,16,38.5,10,6
114,1,0,106,8,33.2,3,5
114,2,0,89,8,34.9,6,2
114,3,0,102,10,31.4,3,7
114,4,0,104,12,33.1,8,4
114,5,0,86,10,33.3,4,6
114,6,0,68,7,31.6,4,3
114,7,0,70,9,33.3,5,4
114,8,0,70,10,32.7,4,6
114,9,0,81,10,34.9,4,6
114,10,0,120,14,34.1,8,6
114,11,0,102,13,32.9,7,6
114,12,0,86,13,35.8,5,8
114,13,0,67,11,31.5,9,2
114,14,0,74,11,31.6,6,5
114,15,0,70,13,31.6,7,6
114,16,0,88,14,35.6,3,11
114,17,0,73,10,33.6,3,7
114,18,0,109,20,32.7,12,8
114,19,0,68,12,32.8,6,6
114,20,0,59,9,32.4,3,6
114,21,0,69,11,33.8,5,6
114,22,0,77,15,32.3,7,8
114,23,0,114,22,32.5,11,11
114,24,0,86,14,32.6,8,6
114,25,0,104,19,32.5,10,9
114,26,0,81,17,35.3,11,6
114,27,0,60,14,32.5,8,6
114,28,0,75,18,31.1,9,9
114,29,0,84,17,33.5,10,7
114,30,0,96,23,33.5,9,14
115,1,0,63,7,37.6,3,4
115,2,0,49,5,37.2,5,0
115,3,0,95,7,36.6,6,1
115,4,0,60,9,40.7,5,4
115,5,0,66,8,39.4,4,4
115,6,0,33,5,40.7,4,1
115,7,0,50,8,40.1,4,4
115,8,0,67,10,40.0,8,2
115,9,0,71,11,37.0,7,4
115,10,0,79,10,36.8,8,2
115,11,0,68,10,42.0,5,5
115,12,0,88,11,40.1,7,4
115,13,0,58,10,38.9,7,3
115,14,0,49,8,40.3,7,1
115,15,0,69,15,31.1,10,5
115,16,0,83,11,40.6,7,4
115,17,0,56,9,37.9,5,4
115,18,0,70,12,40.6,9,3
115,19,0,37,6,40.5,5,1
115,20,0,70,13,38.5,7,6
115,21,0,48,10,41.1,6,4
115,22,0,90,17,42.9,14,3
115,23,0,76,19,40.2,12,7
115,24,0,71,14,38.3,8,6
115,25,0,61,16,37.2,10,6
115,26,0,91,18,41.6,13,5
115,27,0,52,12,37.9,8,4
115,28,0,49,12,37.6,6,6
115,29,0,68,13,38.9,6,7
115,30,0,69,14,38.3,6,8
116,1,1,60,12,25.8,4,8
116,2,1,53,15,25.4,7,8
116,3,1,46,14,24.9,5,9
116,4,1,41,13,27.4,7,6
116,5,1,52,15,28.9,4,11
116,6,1,27,8,25.3,3,5
116,7,1,36,13,23.5,5,8
116,8,1,52,19,26.1,5,14
116,9,1,59,19,27.3,10,9
116,10,1,37,14,27.0,11,3
116,11,1,57,19,27.8,7,12
116,12,1,53,23,25.9,15,8
116,13,1,46,18,24.1,8,10
116,14,1,34,14,26.8,7,7
116,15,1,71,29,22.5,14,15
116,16,1,52,24,24.0,14,10
116,17,1,83,35,27.6,19,16
116,18,1,50,24,27.3,9,15
116,19,1,22,10,29.5,5,5
116,20,1,18,10,25.5,5,5
116,21,1,35,17,23.3,9,8
116,22,1,42,21,27.4,7,14
116,23,1,64,36,25.9,15,21
116,24,1,44,23,24.0,12,11
116,25,1,59,32,27.1,20,12
116,26,1,57,32,27.5,9,23
116,27,1,22,14,23.3,8,6
116,28,1,22,12,25.1,5,7
116,29,1,57,33,26.9,13,20
116,30,1,29,19,26.0,10,9
117,1,1,27,5,24.0,1,4
117,2,1,52,14,24.8,10,4
117,3,1,19,5,23.9,4,1
117,4,1,55,15,27.8,5,10
117,5,1,59,17,25.9,9,8
117,6,1,31,8,26.7,2,6
117,7,1,22,7,24.0,3,4
117,8,1,78,23,27.8,8,15
117,9,1,50,17,24.7,9,8
117,10,1,40,13,23.2,8,5
117,11,1,20,7,25.4,2,5
117,12,1,60,23,23.6,10,13
117,13,1,36,14,25.7,6,8
117,14,1,11,7,27.6,4,3
117,15,1,47,18,29.0,11,7
117,16,1,57,24,26.2,11,13
117,17,1,35,14,25.5,7,7
117,18,1,36,15,22.7,9,6
117,19,1,80,37,27.6,18,19
117,20,1,15,9,27.9,4,5
117,21,1,32,17,22.8,10,7
117,22,1,30,16,27.5,10,6
117,23,1,42,24,24.2,13,11
117,24,1,62,35,21.8,13,22
117,25,1,23,14,26.7,5,9
117,26,1,51,31,25.3,17,14
117,27,1,12,8,22.7,3,5
117,28,1,21,17,23.1,7,10
117,29,1,39,26,28.7,12,14
117,30,1,15,10,23.5,6,4
118,1,0,17,3,77.0,1,2
118,2,0,26,3,77.6,2,1
118,3,0,21,1,75.3,1,0
118,4,0,23,2,80.0,1,1
118,5,0,21,2,78.7,0,2
118,6,0,28,3,74.8,1,2
118,7,0,13,4,76.9,0,4
118,8,0,24,4,73.6,0,4
118,9,0,0,2,77.8,0,2
118,10,0,0,1,75.9,0,1
118,11,0,28,4,78.5,2,2
118,12,0,9,3,74.2,1,2
118,13,0,17,3,73.5,2,1
118,14,0,10,4,79.2,1,3
118,15,0,28,5,90.4,0,5
118,16,0,14,5,76.1,3,2
118,17,0,35,9,76.4,3,6
118,18,0,0,1,76.0,0,1
118,19,0,7,3,76.9,2,1
118,20,0,27,4,70.1,1,3
118,21,0,28,4,76.3,1,3
118,22,0,17,4,74.7,1,3
118,23,0,5,3,79.7,2,1
118,24,0,7,3,76.0,1,2
118,25,0,11,1,74.2,0,1
118,26,0,8,1,75.0,0,1
118,27,0,0,2,74.6,0,2
118,28,0,16,5,78.3,2,3
118,29,0,4,0,77.4,0,0
118,30,0,0,1,78.2,0,1
119,1,0,56,6,76.1,4,2
119,2,0,80,8,75.9,5,3
119,3,0,53,5,78.3,2,3
119,4,0,91,7,75.3,5,2
119,5,0,79,10,78.5,6,4
119,6,0,55,7,74.7,4,3
119,7,0,24,3,76.3,1,2
119,8,0,40,6,75.0,2,4
119,9,0,22,3,75.4,0,3
119,10,0,54,7,74.5,2,5
119,11,0,71,9,75.5,6,3
119,12,0,48,7,76.2,3,4
119,13,0,48,6,77.1,3,3
119,14,0,40,7,76.7,3,4
119,15,0,93,13,76.2,9,4
119,16,0,50,8,78.3,6,2
119,17,0,61,10,73.7,6,4
119,18,0,41,6,79.0,3,3
119,19,0,48,9,78.6,3,6
119,20,0,64,12,74.2,4,8
119,21,0,31,7,79.5,1,6
119,22,0,35,6,79.3,0,6
119,23,0,73,14,78.1,6,8
119,24,0,72,14,79.2,6,8
119,25,0,53,13,76.2,4,9
119,26,0,66,15,80.8,5,10
119,27,0,31,9,76.8,5,4
119,28,0,49,14,77.3,5,9
119,29,0,60,13,77.6,6,7
119,30,0,60,17,80.7,5,12
120,1,0,40,3,50.6,2,1
120,2,0,42,5,50.8,3,2
120,3,0,66,7,49.4,7,0
120,4,0,73,9,50.8,6,3
120,5,0,85,9,47.5,4,5
120,6,0,38,4,48.9,3,1
120,7,0,40,4,52.0,2,2
120,8,0,71,9,53.6,5,4
120,9,0,83,11,50.7,8,3
120,10,0,65,8,51.5,5,3
120,11,0,70,9,50.0,4,5
120,12,0,55,8,50.7,4,4
120,13,0,47,7,50.8,5,2
120,14,0,52,8,52.1,6,2
120,15,0,58,8,51.9,4,4
120,16,0,56,10,47.2,5,5
120,17,0,69,13,47.1,8,5
120,18,0,60,10,48.9,5,5
120,19,0,85,17,54.7,11,6
120,20,0,48,10,47.9,7,3
120,21,0,48,9,52.1,8,1
120,22,0,33,5,51.6,4,1
120,23,0,51,10,50.7,7,3
120,24,0,53,10,49.7,9,1
120,25,0,61,11,51.6,5,6
120,26,0,47,9,49.9,4,5
120,27,0,45,8,51.1,7,1
120,28,0,37,10,49.6,7,3
120,29,0,77,17,48.8,13,4
120,30,0,56,13,50.0,8,5
121,1,0,51,4,37.4,2,2
121,2,0,50,3,34.9,1,2
121,3,0,70,9,34.3,5,4
121,4,0,0,0,36.6,0,0
121,5,0,18,3,31.9,1,2
121,6,0,40,6,34.4,3,3
121,7,0,44,6,36.2,4,2
121,8,0,42,6,38.0,4,2
121,9,0,59,9,37.8,3,6
121,10,0,60,7,35.5,5,2
121,11,0,49,6,39.0,3,3
121,12,0,68,10,36.6,6,4
121,13,0,40,9,38.4,3,6
121,14,0,23,6,38.9,5,1
121,15,0,19,4,29.8,2,2
121,16,0,48,8,34.3,5,3
121,17,0,41,6,35.3,4,2
121,18,0,49,10,36.2,9,1
121,19,0,38,6,35.3,4,2
121,20,0,35,6,38.0,5,1
121,21,0,14,4,37.2,2,2
121,22,0,16,3,34.2,0,3
121,23,0,36,9,34.3,7,2
121,24,0,42,8,33.5,7,1
121,25,0,65,15,35.0,8,7
121,26,0,49,11,36.6,8,3
121,27,0,46,9,37.5,5,4
121,28,0,30,6,36.0,4,2
121,29,0,53,12,39.1,4,8
121,30,0,37,10,38.0,6,4
122,1,0,130,11,41.2,7,4
122,2,0,97,9,39.2,4,5
122,3,0,107,10,39.0,7,3
122,4,0,115,13,35.7,10,3
122,5,0,73,8,37.8,6,2
122,6,0,60,7,42.0,7,0
122,7,0,76,10,33.8,8,2
122,8,0,89,14,36.6,8,6
122,9,0,117,14,36.2,10,4
122,10,0,88,11,37.1,7,4
122,11,0,105,13,34.6,8,5
122,12,0,107,14,36.7,12,2
122,13,0,80,10,33.3,5,5
122,14,0,92,13,39.3,9,4
122,15,0,119,18,37.6,10,8
122,16,0,87,11,39.9,8,3
122,17,0,119,19,41.5,10,9
122,18,0,84,14,34.3,9,5
122,19,0,117,17,38.0,13,4
122,20,0,77,15,37.7,8,7
122,21,0,83,17,34.6,9,8
122,22,0,100,22,40.9,11,11
122,23,0,128,21,37.6,12,9
122,24,0,99,21,35.4,11,10
122,25,0,92,18,38.4,11,7
122,26,0,121,24,33.9,16,8
122,27,0,77,17,38.3,13,4
122,28,0,39,9,42.0,5,4
122,29,0,97,21,36.9,11,10
122,30,0,103,20,37.5,18,2
123,1,0,7,2,36.4,1,1
123,2,0,15,5,36.4,1,4
123,3,0,47,3,32.4,2,1
123,4,0,17,3,33.8,3,0
123,5,0,12,5,34.4,3,2
123,6,0,23,5,38.2,3,2
123,7,0,2,1,35.6,1,0
123,8,0,0,1,35.9,0,1
123,9,0,0,0,36.0,0,0
123,10,0,40,8,37.0,3,5
123,11,0,0,3,35.6,1,2
123,12,0,20,4,31.3,3,1
123,13,0,7,3,33.7,3,0
123,14,0,15,6,33.7,1,5
123,15,0,27,4,40.1,3,1
123,16,0,0,3,37.1,0,3
123,17,0,0,1,37.6,1,0
123,18,0,10,3,36.0,2,1
123,19,0,17,2,33.0,1,1
123,20,0,3,3,38.5,2,1
123,21,0,15,5,33.0,3,2
123,22,0,50,8,34.3,5,3
123,23,0,22,5,36.0,4,1
123,24,0,0,2,36.5,1,1
123,25,0,15,3,32.7,2,1
123,26,0,15,3,34.4,3,0
123,27,0,11,5,33.4,2,3
123,28,0,10,4,35.0,2,2
123,29,0,1,2,37.5,1,1
123,30,0,18,9,36.5,3,6
124,1,0,98,9,53.8,1,8
124,2,0,63,8,53.5,3,5
124,3,0,80,7,54.5,3,4
124,4,0,77,7,55.2,2,5
124,5,0,52,6,51.2,3,3
124,6,0,46,5,53.7,2,3
124,7,0,60,6,52.5,2,4
124,8,0,81,10,51.8,3,7
124,9,0,91,9,54.7,2,7
124,10,0,82,9,53.9,3,6
124,11,0,65,13,51.9,0,13
124,12,0,62,8,47.8,2,6
124,13,0,45,5,51.7,2,3
124,14,0,58,7,53.3,4,3
124,15,0,58,10,48.6,5,5
124,16,0,59,10,53.6,5,5
124,17,0,35,7,53.9,3,4
124,18,0,85,13,53.7,7,6
124,19,0,86,14,51.4,6,8
124,20,0,62,9,52.1,2,7
124,21,0,52,10,51.7,3,7
124,22,0,78,16,52.1,8,8
124,23,0,68,12,50.2,5,7
124,24,0,66,11,53.2,4,7
124,25,0,89,16,51.9,3,13
124,26,0,67,15,54.9,5,10
124,27,0,61,11,52.9,4,7
124,28,0,41,9,53.3,2,7
124,29,0,90,18,51.0,2,16
124,30,0,91,19,50.0,5,14
125,1,0,32,3,26.2,2,1
125,2,0,11,2,18.7,2,0
125,3,0,33,5,23.1,2,3
125,4,0,10,6,24.3,4,2
125,5,0,17,3,22.0,1,2
125,6,0,13,2,23.2,1,1
125,7,0,38,3,23.3,1,2
125,8,0,19,4,25.4,2,2
125,9,0,20,5,20.5,3,2
125,10,0,34,7,25.9,2,5
125,11,0,42,4,23.2,3,1
125,12,0,24,3,23.7,2,1
125,13,0,28,6,25.0,2,4
125,14,0,30,7,21.9,4,3
125,15,0,8,4,19.0,1,3
125,16,0,39,7,26.6,5,2
125,17,0,9,4,22.9,1,3
125,18,0,9,4,23.9,3,1
125,19,0,27,7,25.4,3,4
125,20,0,23,3,22.7,0,3
125,21,0,33,6,23.9,4,2
125,22,0,24,5,23.9,0,5
125,23,0,40,7,25.3,4,3
125,24,0,49,11,22.3,4,7
125,25,0,28,8,21.0,3,5
125,26,0,33,7,27.1,6,1
125,27,0,10,4,21.4,1,3
125,28,0,21,7,20.0,4,3
125,29,0,22,8,23.7,4,4
125,30,0,74,16,23.6,9,7
126,1,0,93,8,58.5,4,4
126,2,0,94,10,58.3,7,3
126,3,0,111,9,63.3,5,4
126,4,0,111,11,59.2,1,10
126,5,0,102,13,59.8,5,8
126,6,0,74,11,56.1,3,8
126,7,0,70,7,56.7,3,4
126,8,0,60,8,56.6,3,5
126,9,0,106,16,61.0,4,12
126,10,0,108,17,58.6,8,9
126,11,0,85,11,60.5,4,7
126,12,0,127,18,56.8,6,12
126,13,0,84,13,57.1,5,8
126,14,0,87,11,61.7,6,5
126,15,0,102,15,69.9,4,11
126,16,0,97,14,61.0,5,9
126,17,0,102,15,61.5,9,6
126,18,0,101,16,59.7,6,10
126,19,0,74,13,58.9,4,9
126,20,0,79,17,57.1,2,15
126,21,0,75,14,59.0,2,12
126,22,0,104,19,58.4,5,14
126,23,0,128,22,54.8,9,13
126,24,0,91,17,51.7,6,11
126,25,0,107,21,57.4,11,10
126,26,0,118,24,58.3,10,14
126,27,0,66,13,57.2,3,10
126,28,0,58,11,57.7,5,6
126,29,0,117,22,59.6,11,11
126,30,0,119,23,58.1,5,18
127,1,1,49,16,69.0,8,8
127,2,1,12,4,68.4,2,2
127,3,1,77,18,68.4,10,8
127,4,1,31,7,67.6,5,2
127,5,1,54,18,69.2,7,11
127,6,1,42,12,69.7,9,3
127,7,1,32,12,69.0,10,2
127,8,1,50,17,67.5,9,8
127,9,1,69,25,67.9,11,14
127,10,1,73,24,68.9,14,10
127,11,1,72,25,66.6,13,12
127,12,1,65,23,68.4,16,7
127,13,1,34,12,70.9,6,6
127,14,1,51,20,68.9,11,9
127,15,1,69,28,72.7,14,14
127,16,1,66,30,69.3,9,21
127,17,1,61,30,69.5,18,12
127,18,1,58,27,70.1,7,20
127,19,1,84,41,68.2,20,21
127,20,1,54,26,68.9,12,14
127,21,1,44,22,71.2,12,10
127,22,1,90,47,65.2,23,24
127,23,1,74,38,71.7,23,15
127,24,1,48,25,68.7,12,13
127,25,1,57,32,70.7,17,15
127,26,1,88,48,67.5,21,27
127,27,1,37,23,69.1,10,13
127,28,1,73,41,71.2,21,20
127,29,1,88,52,70.6,25,27
127,30,1,70,47,71.6,20,27
128,1,1,107,25,24.3,12,13
128,2,1,87,22,23.3,14,8
128,3,1,121,30,27.0,17,13
128,4,1,93,24,23.6,17,7
128,5,1,103,28,25.1,17,11
128,6,1,78,23,23.2,13,10
128,7,1,63,21,24.6,7,14
128,8,1,107,33,22.6,10,23
128,9,1,92,32,24.6,16,16
128,10,1,107,38,19.8,10,28
128,11,1,116,41,21.5,29,12
128,12,1,102,40,24.4,19,21
128,13,1,70,28,25.9,21,7
128,14,1,64,27,24.1,14,13
128,15,1,109,44,26.9,13,31
128,16,1,125,52,23.2,28,24
128,17,1,118,53,23.4,28,25
128,18,1,110,49,23.4,27,22
128,19,1,137,63,28.3,40,23
128,20,1,73,38,24.4,20,18
128,21,1,84,40,28.0,21,19
128,22,1,60,32,23.1,14,18
128,23,1,105,57,27.0,28,29
128,24,1,88,46,23.8,28,18
128,25,1,114,60,25.0,33,27
128,26,1,80,48,23.2,28,20
128,27,1,70,40,25.0,20,20
128,28,1,71,44,22.9,12,32
128,29,1,102,60,26.9,28,32
128,30,1,114,71,24.8,35,36
129,1,0,60,9,78.5,7,2
129,2,0,65,7,76.6,3,4
129,3,0,46,7,72.6,2,5
129,4,0,34,4,76.4,2,2
129,5,0,67,10,71.5,4,6
129,6,0,31,6,71.0,2,4
129,7,0,33,5,75.2,1,4
129,8,0,56,7,76.0,2,5
129,9,0,56,5,74.2,2,3
129,10,0,60,7,74.7,5,2
129,11,0,52,7,72.6,3,4
129,12,0,25,6,77.8,0,6
129,13,0,34,4,78.1,2,2
129,14,0,40,9,74.5,2,7
129,15,0,60,8,64.3,2,6
129,16,0,41,5,77.2,3,2
129,17,0,56,8,75.4,4,4
129,18,0,93,15,73.4,6,9
129,19,0,20,5,76.6,3,2
129,20,0,39,8,74.8,4,4
129,21,0,30,4,73.3,2,2
129,22,0,63,12,73.5,4,8
129,23,0,49,11,70.4,2,9
129,24,0,52,11,73.0,2,9
129,25,0,40,11,76.3,1,10
129,26,0,49,13,75.0,3,10
129,27,0,27,5,74.3,3,2
129,28,0,28,9,71.9,4,5
129,29,0,40,10,77.3,4,6
129,30,0,57,14,74.3,7,7
130,1,0,50,5,47.4,5,0
130,2,0,1,1,47.2,1,0
130,3,0,56,4,50.2,2,2
130,4,0,15,4,48.9,2,2
130,5,0,26,2,45.8,1,1
130,6,0,26,5,51.5,3,2
130,7,0,18,4,49.5,1,3
130,8,0,14,3,47.4,0,3
130,9,0,51,5,44.2,4,1
130,10,0,34,6,50.7,2,4
130,11,0,23,3,42.3,1,2
130,12,0,20,3,47.2,2,1
130,13,0,19,4,49.8,2,2
130,14,0,35,6,49.1,3,3
130,15,0,26,4,41.3,2,2
130,16,0,47,8,46.2,3,5
130,17,0,34,8,47.2,4,4
130,18,0,56,11,46.3,4,7
130,19,0,71,11,47.0,5,6
130,20,0,20,5,46.6,3,2
130,21,0,0,3,47.0,2,1
130,22,0,37,8,51.9,4,4
130,23,0,23,3,44.0,3,0
130,24,0,35,10,48.9,7,3
130,25,0,61,10,49.3,6,4
130,26,0,42,8,47.7,3,5
130,27,0,22,8,46.5,3,5
130,28,0,10,2,49.4,0,2
130,29,0,35,6,48.8,4,2
130,30,0,55,13,46.3,6,7
131,1,0,27,2,22.0,1,1
131,2,0,23,3,22.8,0,3
131,3,0,32,7,20.4,4,3
131,4,0,12,1,22.0,1,0
131,5,0,32,5,21.7,3,2
131,6,0,20,3,21.9,1,2
131,7,0,13,5,20.8,1,4
131,8,0,31,5,20.7,2,3
131,9,0,59,6,21.2,2,4
131,10,0,43,5,21.0,4,1
131,11,0,7,1,22.5,0,1
131,12,0,32,5,21.5,1,4
131,13,0,17,6,22.6,4,2
131,14,0,20,6,20.1,3,3
131,15,0,56,9,17.0,6,3
131,16,0,27,3,23.3,2,1
131,17,0,45,7,19.8,4,3
131,18,0,53,10,22.8,2,8
131,19,0,49,9,20.2,2,7
131,20,0,29,6,19.6,2,4
131,21,0,21,6,22.1,2,4
131,22,0,24,4,20.1,2,2
131,23,0,6,3,20.5,0,3
131,24,0,20,6,25.8,5,1
131,25,0,33,7,20.1,5,2
131,26,0,29,7,19.5,3,4
131,27,0,22,5,22.4,2,3
131,28,0,34,9,20.7,6,3
131,29,0,36,10,20.1,4,6
131,30,0,27,7,22.8,2,5
132,1,0,0,0,20.6,0,0
132,2,0,22,3,18.2,0,3
132,3,0,23,2,18.1,1,1
132,4,0,0,1,20.1,1,0
132,5,0,42,5,20.9,1,4
132,6,0,27,2,21.8,1,1
132,7,0,3,1,22.1,1,0
132,8,0,0,1,17.8,0,1
132,9,0,11,4,23.3,2,2
132,10,0,36,5,21.0,0,5
132,11,0,28,4,20.8,1,3
132,12,0,14,2,19.5,1,1
132,13,0,22,6,21.1,3,3
132,14,0,12,1,15.4,0,1
132,15,0,5,2,13.1,0,2
132,16,0,10,3,17.6,0,3
132,17,0,0,4,21.4,0,4
132,18,0,4,1,19.9,0,1
132,19,0,18,5,22.2,3,2
132,20,0,11,3,21.1,1,2
132,21,0,24,5,22.7,2,3
132,22,0,23,3,16.9,0,3
132,23,0,42,7,17.3,0,7
132,24,0,17,5,24.8,0,5
132,25,0,27,5,16.8,2,3
132,26,0,24,4,20.8,2,2
132,27,0,30,7,20.3,3,4
132,28,0,6,3,19.4,1,2
132,29,0,15,3,20.3,2,1
132,30,0,21,6,18.6,0,6
133,1,0,109,7,50.7,1,6
133,2,0,98,12,51.2,1,11
133,3,0,78,6,56.7,0,6
133,4,0,90,11,52.2,5,6
133,5,0,99,10,50.2,3,7
133,6,0,81,9,53.8,4,5
133,7,0,71,7,50.2,1,6
133,8,0,80,13,52.6,4,9
133,9,0,106,15,48.7,3,12
133,10,0,72,7,55.1,2,5
133,11,0,94,12,52.1,4,8
133,12,0,94,13,56.0,7,6
133,13,0,66,12,47.7,5,7
133,14,0,61,12,52.3,4,8
133,15,0,119,16,53.8,3,13
133,16,0,75,12,49.9,1,11
133,17,0,90,15,51.9,6,9
133,18,0,110,19,51.8,9,10
133,19,0,100,15,52.1,4,11
133,20,0,67,10,50.3,5,5
133,21,0,60,10,51.9,4,6
133,22,0,94,16,50.5,7,9
133,23,0,119,22,52.5,9,13
133,24,0,62,12,51.3,7,5
133,25,0,67,13,50.0,4,9
133,26,0,92,18,50.2,7,11
133,27,0,79,17,52.2,4,13
133,28,0,81,17,48.9,3,14
133,29,0,99,21,52.2,7,14
133,30,0,106,23,50.7,8,15
134,1,0,91,8,72.4,2,6
134,2,0,69,6,72.7,5,1
134,3,0,111,9,72.9,2,7
134,4,0,88,10,75.8,4,6
134,5,0,94,11,69.5,4,7
134,6,0,53,4,73.7,2,2
134,7,0,62,9,75.5,6,3
134,8,0,77,10,75.3,7,3
134,9,0,110,14,73.5,6,8
134,10,0,67,8,71.3,5,3
134,11,0,89,15,74.1,7,8
134,12,0,91,12,73.2,6,6
134,13,0,61,9,69.9,6,3
134,14,0,46,8,73.2,1,7
134,15,0,70,10,74.0,5,5
134,16,0,71,13,70.3,6,7
134,17,0,61,11,73.2,6,5
134,18,0,120,17,75.1,11,6
134,19,0,89,18,71.0,9,9
134,20,0,63,10,70.7,3,7
134,21,0,48,11,67.7,4,7
134,22,0,80,16,73.1,8,8
134,23,0,57,12,71.0,3,9
134,24,0,67,13,74.1,7,6
134,25,0,89,16,77.7,9,7
134,26,0,117,23,71.3,10,13
134,27,0,57,12,74.1,5,7
134,28,0,56,14,72.9,6,8
134,29,0,74,14,69.8,6,8
134,30,0,87,18,70.2,10,8
135,1,1,49,12,35.9,10,2
135,2,1,41,10,35.2,4,6
135,3,1,49,12,36.4,5,7
135,4,1,36,10,33.2,6,4
135,5,1,46,13,37.6,3,10
135,6,1,26,9,34.7,7,2
135,7,1,47,14,35.0,8,6
135,8,1,55,17,36.6,11,6
135,9,1,53,18,36.4,7,11
135,10,1,72,26,36.3,11,15
135,11,1,67,25,37.2,17,8
135,12,1,46,17,32.8,8,9
135,13,1,39,15,35.2,5,10
135,14,1,39,18,33.6,8,10
135,15,1,20,10,35.0,6,4
135,16,1,29,12,36.4,8,4
135,17,1,66,31,33.6,20,11
135,18,1,32,16,36.9,7,9
135,19,1,33,14,36.3,9,5
135,20,1,16,8,35.1,4,4
135,21,1,18,9,37.6,4,5
135,22,1,39,19,33.0,10,9
135,23,1,42,22,31.4,14,8
135,24,1,52,30,35.1,11,19
135,25,1,47,27,34.3,14,13
135,26,1,51,30,36.2,16,14
135,27,1,27,17,34.2,11,6
135,28,1,31,17,35.6,8,9
135,29,1,44,29,35.6,16,13
135,30,1,45,30,32.1,9,21
136,1,0,117,10,39.8,1,9
136,2,0,107,8,40.2,2,6
136,3,0,93,10,41.1,3,7
136,4,0,126,12,43.7,4,8
136,5,0,109,11,41.7,6,5
136,6,0,74,7,41.2,1,6
136,7,0,72,9,39.4,2,7
136,8,0,131,16,36.5,8,8
136,9,0,104,12,42.1,2,10
136,10,0,128,14,41.8,6,8
136,11,0,120,13,41.2,8,5
136,12,0,96,13,44.1,8,5
136,13,0,71,11,40.7,4,7
136,14,0,89,11,39.9,4,7
136,15,0,116,15,47.5,7,8
136,16,0,89,15,42.3,7,8
136,17,0,105,14,39.7,3,11
136,18,0,127,20,40.8,7,13
136,19,0,101,18,42.1,4,14
136,20,0,84,16,39.4,7,9
136,21,0,94,16,41.8,9,7
136,22,0,81,13,39.8,5,8
136,23,0,132,23,40.4,6,17
136,24,0,100,18,37.6,11,7
136,25,0,103,22,39.4,7,15
136,26,0,112,22,40.0,7,15
136,27,0,81,20,37.0,5,15
136,28,0,79,15,39.3,8,7
136,29,0,106,20,41.0,6,14
136,30,0,109,21,41.5,9,12
137,1,0,57,7,48.1,4,3
137,2,0,21,1,50.1,1,0
137,3,0,43,5,51.5,2,3
137,4,0,50,5,49.8,5,0
137,5,0,65,6,49.4,3,3
137,6,0,37,3,49.1,2,1
137,7,0,25,6,49.5,1,5
137,8,0,41,7,50.3,4,3
137,9,0,80,11,49.2,5,6
137,10,0,34,7,48.3,2,5
137,11,0,45,6,46.7,3,3
137,12,0,23,5,48.6,3,2
137,13,0,37,8,49.1,4,4
137,14,0,39,6,50.3,4,2
137,15,0,55,13,51.4,5,8
137,16,0,61,10,49.5,6,4
137,17,0,39,6,53.0,2,4
137,18,0,38,6,48.6,3,3
137,19,0,62,11,48.3,9,2
137,20,0,46,8,50.0,3,5
137,21,0,33,9,49.7,5,4
137,22,0,55,12,49.4,5,7
137,23,0,51,11,50.9,7,4
137,24,0,60,10,49.3,5,5
137,25,0,29,7,52.2,2,5
137,26,0,64,14,52.4,7,7
137,27,0,41,10,49.1,5,5
137,28,0,39,9,49.9,8,1
137,29,0,52,11,51.0,6,5
137,30,0,32,6,49.3,2,4
138,1,0,4,2,36.6,2,0
138,2,0,23,1,34.7,1,0
138,3,0,15,2,35.4,1,1
138,4,0,29,5,39.8,3,2
138,5,0,14,1,37.7,1,0
138,6,0,8,1,38.7,1,0
138,7,0,4,2,36.9,2,0
138,8,0,27,3,35.5,2,1
138,9,0,21,3,36.8,2,1
138,10,0,18,3,37.1,2,1
138,11,0,0,1,38.2,1,0
138,12,0,0,5,40.3,4,1
138,13,0,0,2,37.9,1,1
138,14,0,17,5,38.7,2,3
138,15,0,1,2,38.6,1,1
138,16,0,7,2,39.7,0,2
138,17,0,44,7,42.5,5,2
138,18,0,5,3,39.2,1,2
138,19,0,0,2,41.5,1,1
138,20,0,11,3,40.7,1,2
138,21,0,0,1,39.6,1,0
138,22,0,15,3,36.8,3,0
138,23,0,3,2,35.2,2,0
138,24,0,22,5,43.6,3,2
138,25,0,13,5,38.9,3,2
138,26,0,24,7,37.1,4,3
138,27,0,10,2,38.5,2,0
138,28,0,2,4,39.3,4,0
138,29,0,7,5,35.9,4,1
138,30,0,17,6,36.2,4,2
139,1,0,36,6,65.8,5,1
139,2,0,46,4,65.8,4,0
139,3,0,21,3,62.8,1,2
139,4,0,32,5,68.2,5,0
139,5,0,36,7,65.5,2,5
139,6,0,31,3,66.8,2,1
139,7,0,31,7,68.2,2,5
139,8,0,44,7,68.7,2,5
139,9,0,45,4,64.8,2,2
139,10,0,54,7,65.5,3,4
139,11,0,31,5,67.9,3,2
139,12,0,48,8,66.2,3,5
139,13,0,36,5,66.8,3,2
139,14,0,29,5,67.9,2,3
139,15,0,53,7,72.3,4,3
139,16,0,51,9,68.2,2,7
139,17,0,61,9,65.4,4,5
139,18,0,12,2,68.7,1,1
139,19,0,42,9,67.2,4,5
139,20,0,44,7,66.6,2,5
139,21,0,27,6,65.7,4,2
139,22,0,34,5,69.9,3,2
139,23,0,18,3,65.0,2,1
139,24,0,51,9,67.1,3,6
139,25,0,54,12,68.2,4,8
139,26,0,50,11,64.5,7,4
139,27,0,34,6,64.6,2,4
139,28,0,29,8,67.0,4,4
139,29,0,51,10,63.3,5,5
139,30,0,29,5,65.5,2,3
140,1,0,46,3,41.7,2,1
140,2,0,77,6,44.3,5,1
140,3,0,67,6,42.3,4,2
140,4,0,78,7,44.3,5,2
140,5,0,60,5,45.3,4,1
140,6,0,29,4,41.9,2,2
140,7,0,47,8,45.5,5,3
140,8,0,69,9,43.0,4,5
140,9,0,82,9,43.3,4,5
140,10,0,43,4,45.1,4,0
140,11,0,65,9,43.9,6,3
140,12,0,66,11,44.0,9,2
140,13,0,58,8,47.2,3,5
140,14,0,48,6,44.1,3,3
140,15,0,51,8,39.5,5,3
140,16,0,92,15,44.6,7,8
140,17,0,67,9,43.3,7,2
140,18,0,74,14,41.3,7,7
140,19,0,51,8,45.3,6,2
140,20,0,40,6,44.1,4,2
140,21,0,32,9,41.4,7,2
140,22,0,62,12,42.1,9,3
140,23,0,88,18,43.8,12,6
140,24,0,70,15,45.7,8,7
140,25,0,81,14,45.8,11,3
140,26,0,92,19,44.5,14,5
140,27,0,64,15,45.1,10,5
140,28,0,41,9,42.1,6,3
140,29,0,83,18,41.5,14,4
140,30,0,82,17,41.7,7,10
141,1,0,0,3,22.9,1,2
141,2,0,2,6,24.5,3,3
141,3,0,32,2,23.6,1,1
141,4,0,0,3,18.6,0,3
141,5,0,32,6,22.6,2,4
141,6,0,9,1,19.2,0,1
141,7,0,21,5,21.3,4,1
141,8,0,9,2,20.2,1,1
141,9,0,29,6,22.6,2,4
141,10,0,36,5,23.1,4,1
141,11,0,19,3,22.6,0,3
141,12,0,26,4,18.3,1,3
141,13,0,14,6,19.3,1,5
141,14,0,3,2,16.2,0,2
141,15,0,29,3,28.6,1,2
141,16,0,26,3,19.1,0,3
141,17,0,64,11,19.4,2,9
141,18,0,0,3,21.5,0,3
141,19,0,6,3,18.4,0,3
141,20,0,14,3,21.9,1,2
141,21,0,4,3,23.6,1,2
141,22,0,22,4,18.6,1,3
141,23,0,3,0,22.6,0,0
141,24,0,37,9,22.2,5,4
141,25,0,15,4,25.6,2,2
141,26,0,12,5,21.9,2,3
141,27,0,17,7,20.6,3,4
141,28,0,37,8,22.6,0,8
141,29,0,1,3,24.6,2,1
141,30,0,26,7,20.9,2,5
142,1,0,14,2,48.5,1,1
142,2,0,0,3,48.4,1,2
142,3,0,0,3,50.4,1,2
142,4,0,0,2,50.0,0,2
142,5,0,6,1,45.4,0,1
142,6,0,0,2,49.8,1,1
142,7,0,25,2,49.5,0,2
142,8,0,1,2,51.4,1,1
142,9,0,14,5,47.7,1,4
142,10,0,3,2,48.8,1,1
142,11,0,17,3,46.8,1,2
142,12,0,1,2,51.8,2,0
142,13,0,23,4,48.9,3,1
142,14,0,0,1,50.9,1,0
142,15,0,10,3,43.0,2,1
142,16,0,41,6,48.3,3,3
142,17,0,16,2,50.0,0,2
142,18,0,0,3,51.0,0,3
142,19,0,38,7,48.0,2,5
142,20,0,17,3,52.7,1,2
142,21,0,3,2,48.4,0,2
142,22,0,9,4,51.0,1,3
142,23,0,25,7,51.5,1,6
142,24,0,13,5,50.7,2,3
142,25,0,33,6,48.8,0,6
142,26,0,0,1,49.7,1,0
142,27,0,0,2,52.0,1,1
142,28,0,0,1,50.3,1,0
142,29,0,34,6,52.6,2,4
142,30,0,22,7,48.3,3,4
143,1,0,77,7,58.8,2,5
143,2,0,51,6,62.2,3,3
143,3,0,66,10,60.4,5,5
143,4,0,68,5,58.8,3,2
143,5,0,63,5,59.1,4,1
143,6,0,51,5,59.4,1,4
143,7,0,44,8,58.2,6,2
143,8,0,69,8,59.6,5,3
143,9,0,81,8,59.7,4,4
143,10,0,90,14,60.8,7,7
143,11,0,74,12,61.5,5,7
143,12,0,57,9,57.8,3,6
143,13,0,50,7,58.2,4,3
143,14,0,50,9,60.8,5,4
143,15,0,71,9,63.5,5,4
143,16,0,49,7,58.5,2,5
143,17,0,58,10,59.4,4,6
143,18,0,67,10,61.3,8,2
143,19,0,83,14,57.8,5,9
143,20,0,33,7,59.1,1,6
143,21,0,50,11,58.7,7,4
143,22,0,72,12,59.0,7,5
143,23,0,77,14,61.3,6,8
143,24,0,76,15,59.4,7,8
143,25,0,96,20,60.7,13,7
143,26,0,64,11,59.6,5,6
143,27,0,49,13,58.3,8,5
143,28,0,47,8,60.7,4,4
143,29,0,50,10,58.1,7,3
143,30,0,76,16,61.5,7,9
144,1,1,45,11,76.0,7,4
144,2,1,35,9,78.3,3,6
144,3,1,6,7,75.9,1,6
144,4,1,52,18,77.8,13,5
144,5,1,23,8,75.4,1,7
144,6,1,6,2,77.3,1,1
144,7,1,38,13,79.6,8,5
144,8,1,49,18,78.9,13,5
144,9,1,22,10,77.0,5,5
144,10,1,6,3,77.9,3,0
144,11,1,42,17,74.3,8,9
144,12,1,31,12,78.1,4,8
144,13,1,31,14,77.5,8,6
144,14,1,17,9,81.2,5,4
144,15,1,22,13,77.9,7,6
144,16,1,26,15,76.5,5,10
144,17,1,14,5,75.5,3,2
144,18,1,0,6,78.9,4,2
144,19,1,48,23,77.5,9,14
144,20,1,27,15,77.3,8,7
144,21,1,10,4,78.1,1,3
144,22,1,38,20,77.5,12,8
144,23,1,40,23,77.7,15,8
144,24,1,45,25,75.2,9,16
144,25,1,41,24,76.7,15,9
144,26,1,11,9,75.9,2,7
144,27,1,6,6,79.4,2,4
144,28,1,30,19,78.0,8,11
144,29,1,29,18,76.6,9,9
144,30,1,30,19,75.3,8,11
145,1,0,117,9,22.2,6,3
145,2,0,125,15,21.9,10,5
145,3,0,102,12,18.2,9,3
145,4,0,103,11,20.3,7,4
145,5,0,127,12,27.1,10,2
145,6,0,74,8,20.9,6,2
145,7,0,74,10,20.6,7,3
145,8,0,101,14,20.2,7,7
145,9,0,82,10,19.4,6,4
145,10,0,120,15,19.6,8,7
145,11,0,137,17,17.6,8,9
145,12,0,118,15,22.0,11,4
145,13,0,104,16,21.7,14,2
145,14,0,85,10,20.5,6,4
145,15,0,124,17,15.9,11,6
145,16,0,140,21,15.8,14,7
145,17,0,129,19,20.6,15,4
145,18,0,125,22,21.3,13,9
145,19,0,128,20,15.4,16,4
145,20,0,86,15,18.9,12,3
145,21,0,79,15,17.8,6,9
145,22,0,107,23,19.4,16,7
145,23,0,110,20,18.3,14,6
145,24,0,134,28,18.4,17,11
145,25,0,111,21,21.1,14,7
145,26,0,103,20,17.3,10,10
145,27,0,72,15,20.8,7,8
145,28,0,74,17,19.3,13,4
145,29,0,121,28,20.6,18,10
145,30,0,101,24,24.1,19,5
146,1,0,33,2,77.0,0,2
146,2,0,59,5,75.1,4,1
146,3,0,48,5,74.8,4,1
146,4,0,50,5,72.8,3,2
146,5,0,55,4,72.0,3,1
146,6,0,47,6,74.1,3,3
146,7,0,51,5,74.7,1,4
146,8,0,65,9,69.6,4,5
146,9,0,44,6,70.0,1,5
146,10,0,47,6,70.3,1,5
146,11,0,71,10,73.1,6,4
146,12,0,67,9,68.0,5,4
146,13,0,40,8,71.5,5,3
146,14,0,29,6,71.6,3,3
146,15,0,35,5,74.4,4,1
146,16,0,69,13,73.4,7,6
146,17,0,75,16,71.2,7,9
146,18,0,50,8,69.1,2,6
146,19,0,33,8,74.5,3,5
146,20,0,31,5,71.9,4,1
146,21,0,45,8,74.5,5,3
146,22,0,41,7,73.4,5,2
146,23,0,66,11,68.0,4,7
146,24,0,37,8,73.0,4,4
146,25,0,62,12,73.6,3,9
146,26,0,52,12,69.9,4,8
146,27,0,26,5,72.1,3,2
146,28,0,37,8,74.6,5,3
146,29,0,36,8,72.7,3,5
146,30,0,79,17,73.5,8,9
147,1,0,66,8,51.9,2,6
147,2,0,54,8,48.3,6,2
147,3,0,77,8,49.0,6,2
147,4,0,74,10,46.5,4,6
147,5,0,26,2,46.3,2,0
147,6,0,32,6,50.8,4,2
147,7,0,34,5,50.1,4,1
147,8,0,43,6,50.3,3,3
147,9,0,33,9,45.1,6,3
147,10,0,21,4,46.3,1,3
147,11,0,67,8,49.0,6,2
147,12,0,35,8,48.0,8,0
147,13,0,25,4,47.4,4,0
147,14,0,38,9,49.2,3,6
147,15,0,14,1,45.9,1,0
147,16,0,29,6,46.2,6,0
147,17,0,61,10,48.5,7,3
147,18,0,55,10,48.3,8,2
147,19,0,68,13,49.2,8,5
147,20,0,39,6,43.4,4,2
147,21,0,35,6,48.4,4,2
147,22,0,41,8,44.7,4,4
147,23,0,22,5,48.1,4,1
147,24,0,61,14,47.0,9,5
147,25,0,73,14,47.7,9,5
147,26,0,47,9,49.7,7,2
147,27,0,46,9,47.8,7,2
147,28,0,26,8,47.6,7,1
147,29,0,53,11,51.1,9,2
147,30,0,60,13,52.3,8,5
148,1,0,83,5,33.1,3,2
148,2,0,74,6,32.6,6,0
148,3,0,96,8,30.9,6,2
148,4,0,96,10,33.0,4,6
148,5,0,122,13,33.8,5,8
148,6,0,67,8,29.8,6,2
148,7,0,54,5,34.6,5,0
148,8,0,105,11,31.4,5,6
148,9,0,88,10,35.9,5,5
148,10,0,112,13,32.0,4,9
148,11,0,128,17,29.5,5,12
148,12,0,100,13,35.7,9,4
148,13,0,77,11,33.2,8,3
148,14,0,66,11,32.5,5,6
148,15,0,114,18,17.8,7,11
148,16,0,142,22,35.2,11,11
148,17,0,122,21,30.8,13,8
148,18,0,108,17,32.5,11,6
148,19,0,109,17,31.1,6,11
148,20,0,66,14,32.9,9,5
148,21,0,50,11,34.0,4,7
148,22,0,99,17,33.5,5,12
148,23,0,107,18,35.7,14,4
148,24,0,88,16,31.1,10,6
148,25,0,73,14,34.3,6,8
148,26,0,103,22,35.1,9,13
148,27,0,61,14,36.1,7,7
148,28,0,72,14,31.0,4,10
148,29,0,91,20,34.6,9,11
148,30,0,104,20,28.6,11,9
149,1,0,11,0,64.4,0,0
149,2,0,11,4,58.7,1,3
149,3,0,0,2,59.0,2,0
149,4,0,18,4,65.4,2,2
149,5,0,17,3,59.0,1,2
149,6,0,7,3,67.1,1,2
149,7,0,18,2,63.2,1,1
149,8,0,9,3,61.2,3,0
149,9,0,11,3,63.6,1,2
149,10,0,48,7,63.3,4,3
149,11,0,31,3,63.8,1,2
149,12,0,8,2,62.5,1,1
149,13,0,0,3,64.3,2,1
149,14,0,9,2,59.6,1,1
149,15,0,20,3,60.1,1,2
149,16,0,14,6,63.9,3,3
149,17,0,0,2,61.9,2,0
149,18,0,46,8,58.3,4,4
149,19,0,56,9,61.9,6,3
149,20,0,37,10,68.1,7,3
149,21,0,11,6,64.0,4,2
149,22,0,6,3,62.9,2,1
149,23,0,27,6,65.5,3,3
149,24,0,32,8,60.2,3,5
149,25,0,39,8,62.6,6,2
149,26,0,30,10,64.5,5,5
149,27,0,18,4,63.2,1,3
149,28,0,15,9,64.8,6,3
149,29,0,24,9,64.8,1,8
149,30,0,21,4,63.4,2,2
150,1,1,80,19,58.7,9,10
150,2,1,99,24,59.4,13,11
150,3,1,104,26,57.9,14,12
150,4,1,80,22,57.0,13,9
150,5,1,107,30,61.1,16,14
150,6,1,71,23,58.8,12,11
150,7,1,58,20,58.9,9,11
150,8,1,57,20,55.9,8,12
150,9,1,91,31,60.3,20,11
150,10,1,67,23,56.2,9,14
150,11,1,100,35,53.9,18,17
150,12,1,91,37,60.1,16,21
150,13,1,63,27,59.0,17,10
150,14,1,56,23,58.2,12,11
150,15,1,95,38,51.9,19,19
150,16,1,123,53,57.7,21,32
150,17,1,76,34,57.0,20,14
150,18,1,81,42,56.7,20,22
150,19,1,97,45,57.3,22,23
150,20,1,82,41,59.0,31,10
150,21,1,54,26,57.5,16,10
150,22,1,79,39,60.3,22,17
150,23,1,89,45,58.5,25,20
150,24,1,112,61,59.2,37,24
150,25,1,98,53,55.9,24,29
150,26,1,106,57,55.4,24,33
150,27,1,60,36,59.5,18,18
150,28,1,71,42,54.3,14,28
150,29,1,71,43,56.1,26,17
150,30,1,97,59,59.1,33,26
151,1,0,100,8,53.6,5,3
151,2,0,106,11,54.5,7,4
151,3,0,107,8,50.6,6,2
151,4,0,85,10,52.9,5,5
151,5,0,105,12,53.9,9,3
151,6,0,54,10,51.5,7,3
151,7,0,74,9,52.6,8,1
151,8,0,88,12,55.8,4,8
151,9,0,108,11,53.9,3,8
151,10,0,81,10,53.7,7,3
151,11,0,105,12,53.5,10,2
151,12,0,95,12,51.6,7,5
151,13,0,65,8,51.7,8,0
151,14,0,74,10,51.8,7,3
151,15,0,113,16,56.9,10,6
151,16,0,100,15,54.4,13,2
151,17,0,93,13,51.7,10,3
151,18,0,71,14,54.5,9,5
151,19,0,100,20,51.3,14,6
151,20,0,89,15,51.1,9,6
151,21,0,66,11,52.5,5,6
151,22,0,92,18,56.7,10,8
151,23,0,104,19,55.8,13,6
151,24,0,90,18,51.1,13,5
151,25,0,91,16,52.0,13,3
151,26,0,100,20,54.3,11,9
151,27,0,72,16,49.1,11,5
151,28,0,61,14,53.7,9,5
151,29,0,90,17,52.1,15,2
151,30,0,95,19,52.7,13,6
152,1,0,80,8,44.2,4,4
152,2,0,79,8,41.4,5,3
152,3,0,56,6,43.7,4,2
152,4,0,78,7,44.0,2,5
152,5,0,92,9,43.8,4,5
152,6,0,59,6,46.1,4,2
152,7,0,57,6,42.6,2,4
152,8,0,76,10,45.4,3,7
152,9,0,82,8,40.8,4,4
152,10,0,79,9,44.5,6,3
152,11,0,78,11,43.3,3,8
152,12,0,87,12,41.3,4,8
152,13,0,42,6,40.2,3,3
152,14,0,59,10,43.5,4,6
152,15,0,74,10,42.3,5,5
152,16,0,78,11,44.5,5,6
152,17,0,69,11,45.9,5,6
152,18,0,80,12,43.6,2,10
152,19,0,84,12,48.9,8,4
152,20,0,62,12,45.6,8,4
152,21,0,53,10,43.8,4,6
152,22,0,66,12,44.0,4,8
152,23,0,59,10,45.5,6,4
152,24,0,63,11,42.7,5,6
152,25,0,60,13,43.2,9,4
152,26,0,96,20,45.1,14,6
152,27,0,46,12,43.5,6,6
152,28,0,37,9,41.1,4,5
152,29,0,85,20,46.7,8,12
152,30,0,80,16,41.6,9,7
153,1,0,116,10,45.9,7,3
153,2,0,118,10,42.1,3,7
153,3,0,122,12,42.6,5,7
153,4,0,97,12,45.7,8,4
153,5,0,98,10,45.9,2,8
153,6,0,58,10,41.9,8,2
153,7,0,68,6,45.2,3,3
153,8,0,84,11,42.1,8,3
153,9,0,129,14,44.1,5,9
153,10,0,71,8,44.9,5,3
153,11,0,118,15,42.4,8,7
153,12,0,112,17,42.5,11,6
153,13,0,75,12,41.9,4,8
153,14,0,72,12,44.3,8,4
153,15,0,85,13,41.9,5,8
153,16,0,94,15,43.7,7,8
153,17,0,85,17,41.6,12,5
153,18,0,90,14,46.7,9,5
153,19,0,101,18,44.9,7,11
153,20,0,77,13,42.7,9,4
153,21,0,58,9,44.0,6,3
153,22,0,114,21,40.3,12,9
153,23,0,107,20,43.1,14,6
153,24,0,116,23,43.9,14,9
153,25,0,97,18,41.4,9,9
153,26,0,90,17,44.0,9,8
153,27,0,69,14,43.5,5,9
153,28,0,70,15,47.3,7,8
153,29,0,118,24,45.5,18,6
153,30,0,101,23,43.3,11,12
154,1,0,104,8,51.6,4,4
154,2,0,95,9,48.9,4,5
154,3,0,95,8,48.7,3,5
154,4,0,106,11,50.7,7,4
154,5,0,97,8,55.6,1,7
154,6,0,56,5,53.5,0,5
154,7,0,59,7,51.4,1,6
154,8,0,91,12,53.0,7,5
154,9,0,96,12,48.1,2,10
154,10,0,115,17,49.6,6,11
154,11,0,101,13,51.4,7,6
154,12,0,110,16,53.1,5,11
154,13,0,65,10,47.9,3,7
154,14,0,75,11,50.5,2,9
154,15,0,118,16,58.7,5,11
154,16,0,101,14,48.3,1,13
154,17,0,104,18,51.1,5,13
154,18,0,124,22,51.5,7,15
154,19,0,111,18,51.6,10,8
154,20,0,90,15,51.4,7,8
154,21,0,76,15,53.8,6,9
154,22,0,103,16,53.1,6,10
154,23,0,121,22,49.8,12,10
154,24,0,99,19,52.0,6,13
154,25,0,80,16,50.8,7,9
154,26,0,98,18,53.3,7,11
154,27,0,78,17,50.5,5,12
154,28,0,54,12,51.3,5,7
154,29,0,101,19,48.0,3,16
154,30,0,114,27,51.5,7,20
155,1,0,9,2,71.4,0,2
155,2,0,26,4,69.6,2,2
155,3,0,44,5,68.0,1,4
155,4,0,39,5,71.8,3,2
155,5,0,6,3,69.2,0,3
155,6,0,22,5,67.3,2,3
155,7,0,6,1,72.4,0,1
155,8,0,31,3,70.6,1,2
155,9,0,48,7,72.1,3,4
155,10,0,16,2,69.3,0,2
155,11,0,35,6,69.3,3,3
155,12,0,28,4,71.0,0,4
155,13,0,38,8,67.7,2,6
155,14,0,11,3,72.8,2,1
155,15,0,42,11,69.8,4,7
155,16,0,16,3,67.5,1,2
155,17,0,20,2,68.5,1,1
155,18,0,41,10,71.4,5,5
155,19,0,25,5,68.8,1,4
155,20,0,42,11,69.8,4,7
155,21,0,21,6,69.1,3,3
155,22,0,25,4,67.7,1,3
155,23,0,28,8,70.4,3,5
155,24,0,38,9,71.5,4,5
155,25,0,39,8,69.8,4,4
155,26,0,15,6,69.9,2,4
155,27,0,30,6,69.2,3,3
155,28,0,29,8,66.9,0,8
155,29,0,5,2,71.2,0,2
155,30,0,43,12,69.1,4,8
156,1,1,47,14,51.9,2,12
156,2,1,52,12,49.1,7,5
156,3,1,57,15,46.8,9,6
156,4,1,51,13,47.2,4,9
156,5,1,38,15,49.4,7,8
156,6,1,37,12,48.4,9,3
156,7,1,39,15,46.7,7,8
156,8,1,55,19,43.0,11,8
156,9,1,34,12,50.7,8,4
156,10,1,11,4,44.2,1,3
156,11,1,52,20,47.5,7,13
156,12,1,51,19,47.7,9,10
156,13,1,29,10,47.1,4,6
156,14,1,26,11,47.3,6,5
156,15,1,49,22,54.7,12,10
156,16,1,56,25,48.6,16,9
156,17,1,59,28,49.7,17,11
156,18,1,21,11,46.6,5,6
156,19,1,33,14,45.4,6,8
156,20,1,31,17,41.6,9,8
156,21,1,48,27,46.9,19,8
156,22,1,48,23,47.0,12,11
156,23,1,49,27,49.1,14,13
156,24,1,54,30,48.6,16,14
156,25,1,42,23,47.3,5,18
156,26,1,44,28,45.7,12,16
156,27,1,22,15,50.0,5,10
156,28,1,17,10,46.7,6,4
156,29,1,25,15,50.6,10,5
156,30,1,66,41,46.2,14,27
157,1,1,92,21,30.5,9,12
157,2,1,94,22,31.5,10,12
157,3,1,92,24,31.8,14,10
157,4,1,79,22,32.5,15,7
157,5,1,122,34,29.8,22,12
157,6,1,63,18,28.8,8,10
157,7,1,63,22,26.5,13,9
157,8,1,100,32,29.6,16,16
157,9,1,106,35,29.0,15,20
157,10,1,102,34,26.1,14,20
157,11,1,89,32,36.0,21,11
157,12,1,88,31,30.9,20,11
157,13,1,73,30,31.6,13,17
157,14,1,69,29,34.5,21,8
157,15,1,115,47,33.0,20,27
157,16,1,81,34,25.5,15,19
157,17,1,83,39,27.6,25,14
157,18,1,67,31,31.9,11,20
157,19,1,103,50,32.8,19,31
157,20,1,72,34,27.0,14,20
157,21,1,53,29,30.0,13,16
157,22,1,99,49,30.2,19,30
157,23,1,115,60,28.6,22,38
157,24,1,91,49,29.2,17,32
157,25,1,95,51,30.0,30,21
157,26,1,68,39,28.1,23,16
157,27,1,82,45,31.6,21,24
157,28,1,68,40,31.6,23,17
157,29,1,80,48,26.4,27,21
157,30,1,97,59,29.2,32,27
158,1,0,58,5,64.4,3,2
158,2,0,41,5,66.0,3,2
158,3,0,65,7,69.0,5,2
158,4,0,84,11,70.3,5,6
158,5,0,89,11,68.0,5,6
158,6,0,62,8,72.3,7,1
158,7,0,43,6,68.5,3,3
158,8,0,48,6,66.4,2,4
158,9,0,59,10,64.4,5,5
158,10,0,46,7,66.2,4,3
158,11,0,63,9,70.1,9,0
158,12,0,86,13,70.8,10,3
158,13,0,40,4,64.9,1,3
158,14,0,41,7,70.6,3,4
158,15,0,41,6,63.9,2,4
158,16,0,56,9,66.6,8,1
158,17,0,67,9,70.0,5,4
158,18,0,49,11,68.2,7,4
158,19,0,47,7,71.1,6,1
158,20,0,40,7,69.7,3,4
158,21,0,46,9,65.5,6,3
158,22,0,66,12,68.4,6,6
158,23,0,77,14,67.1,7,7
158,24,0,52,10,65.8,6,4
158,25,0,74,15,65.9,9,6
158,26,0,70,15,69.8,9,6
158,27,0,28,8,65.6,5,3
158,28,0,38,8,65.4,6,2
158,29,0,60,12,72.3,9,3
158,30,0,65,15,64.8,8,7
159,1,0,92,6,20.3,3,3
159,2,0,94,10,18.9,4,6
159,3,0,110,10,21.5,6,4
159,4,0,83,14,19.9,2,12
159,5,0,81,12,20.2,6,6
159,6,0,86,10,23.0,6,4
159,7,0,77,9,21.7,5,4
159,8,0,85,14,24.0,11,3
159,9,0,60,7,17.4,4,3
159,10,0,95,13,24.1,9,4
159,11,0,66,8,20.1,5,3
159,12,0,72,10,23.3,3,7
159,13,0,71,8,20.9,3,5
159,14,0,40,9,25.9,4,5
159,15,0,70,9,20.8,6,3
159,16,0,91,13,23.4,6,7
159,17,0,87,13,22.5,9,4
159,18,0,112,17,21.6,10,7
159,19,0,93,15,24.2,7,8
159,20,0,78,15,26.8,9,6
159,21,0,54,10,23.3,6,4
159,22,0,64,14,21.3,6,8
159,23,0,108,19,25.0,10,9
159,24,0,98,18,22.4,11,7
159,25,0,72,13,20.8,8,5
159,26,0,69,13,21.7,8,5
159,27,0,73,13,20.6,7,6
159,28,0,76,15,23.6,13,2
159,29,0,77,16,19.7,7,9
159,30,0,108,24,21.9,12,12
160,1,0,29,3,63.8,1,2
160,2,0,72,7,65.1,4,3
160,3,0,48,7,63.7,1,6
160,4,0,32,3,64.6,1,2
160,5,0,22,3,64.8,2,1
160,6,0,40,8,62.4,2,6
160,7,0,41,6,64.0,3,3
160,8,0,44,4,62.8,1,3
160,9,0,53,5,67.4,3,2
160,10,0,36,3,62.8,3,0
160,11,0,52,6,66.5,3,3
160,12,0,37,5,63.4,1,4
160,13,0,26,7,65.3,2,5
160,14,0,35,5,62.9,0,5
160,15,0,35,6,71.4,2,4
160,16,0,40,7,67.8,2,5
160,17,0,91,17,64.5,10,7
160,18,0,55,10,64.6,2,8
160,19,0,49,9,67.5,3,6
160,20,0,30,5,66.3,2,3
160,21,0,36,6,61.2,1,5
160,22,0,40,7,63.7,2,5
160,23,0,71,13,65.5,3,10
160,24,0,68,14,59.7,2,12
160,25,0,57,10,62.9,3,7
160,26,0,68,13,63.2,2,11
160,27,0,27,7,68.2,3,4
160,28,0,45,8,60.9,6,2
160,29,0,60,12,64.4,2,10
160,30,0,57,15,66.0,8,7
161,1,1,55,14,49.8,3,11
161,2,1,73,18,57.8,10,8
161,3,1,36,11,52.0,5,6
161,4,1,44,13,56.6,7,6
161,5,1,62,19,52.1,7,12
161,6,1,41,15,56.8,5,10
161,7,1,27,7,54.1,5,2
161,8,1,59,19,52.9,9,10
161,9,1,70,25,50.6,9,16
161,10,1,64,22,50.8,9,13
161,11,1,43,20,51.0,10,10
161,12,1,75,29,54.4,17,12
161,13,1,41,17,53.0,10,7
161,14,1,45,21,55.5,11,10
161,15,1,63,26,59.1,14,12
161,16,1,55,23,58.1,16,7
161,17,1,54,23,52.5,16,7
161,18,1,72,32,51.5,14,18
161,19,1,50,23,53.7,12,11
161,20,1,33,18,56.9,8,10
161,21,1,44,23,52.7,13,10
161,22,1,55,28,57.5,14,14
161,23,1,43,22,51.9,6,16
161,24,1,63,34,54.7,19,15
161,25,1,74,41,56.5,22,19
161,26,1,71,40,56.9,21,19
161,27,1,17,11,53.8,6,5
161,28,1,42,24,54.5,17,7
161,29,1,42,26,53.9,17,9
161,30,1,34,20,54.4,13,7
162,1,0,65,5,77.8,1,4
162,2,0,37,3,79.5,1,2
162,3,0,20,2,79.8,0,2
162,4,0,60,10,79.1,3,7
162,5,0,46,7,78.6,1,6
162,6,0,14,6,75.4,2,4
162,7,0,28,5,83.6,1,4
162,8,0,40,9,80.7,4,5
162,9,0,43,7,77.4,3,4
162,10,0,53,7,81.0,4,3
162,11,0,44,5,79.5,2,3
162,12,0,48,6,74.8,1,5
162,13,0,41,8,77.9,4,4
162,14,0,40,8,77.9,4,4
162,15,0,60,11,78.8,2,9
162,16,0,25,4,79.7,0,4
162,17,0,29,6,76.4,4,2
162,18,0,48,9,76.7,4,5
162,19,0,41,6,81.5,1,5
162,20,0,29,4,80.6,1,3
162,21,0,42,10,80.4,1,9
162,22,0,47,8,81.4,3,5
162,23,0,49,9,78.3,7,2
162,24,0,61,12,81.2,4,8
162,25,0,46,10,80.7,5,5
162,26,0,37,7,73.9,5,2
162,27,0,42,8,80.7,5,3
162,28,0,42,9,76.2,2,7
162,29,0,55,11,80.6,5,6
162,30,0,55,12,80.3,6,6
163,1,0,83,9,48.6,2,7
163,2,0,109,13,53.7,7,6
163,3,0,102,8,52.3,4,4
163,4,0,97,8,49.0,1,7
163,5,0,97,9,47.6,2,7
163,6,0,52,8,50.0,3,5
163,7,0,47,5,48.0,1,4
163,8,0,95,11,50.0,6,5
163,9,0,75,11,50.0,1,10
163,10,0,98,11,49.1,5,6
163,11,0,103,14,50.4,4,10
163,12,0,85,11,44.3,3,8
163,13,0,57,9,49.0,1,8
163,14,0,46,7,49.4,1,6
163,15,0,107,15,44.4,6,9
163,16,0,74,11,50.6,3,8
163,17,0,90,16,46.7,6,10
163,18,0,97,17,47.3,7,10
163,19,0,88,13,46.1,5,8
163,20,0,57,10,51.9,3,7
163,21,0,71,12,50.5,4,8
163,22,0,73,15,49.7,7,8
163,23,0,83,18,45.7,4,14
163,24,0,109,19,49.7,14,5
163,25,0,87,21,51.2,6,15
163,26,0,104,19,49.2,9,10
163,27,0,63,13,51.3,5,8
163,28,0,69,15,48.6,3,12
163,29,0,95,20,50.4,11,9
163,30,0,94,20,47.2,9,11
164,1,0,100,8,46.9,3,5
164,2,0,99,9,43.2,4,5
164,3,0,106,9,44.3,4,5
164,4,0,81,7,41.0,4,3
164,5,0,76,8,43.0,5,3
164,6,0,62,6,43.8,3,3
164,7,0,68,7,41.5,3,4
164,8,0,98,12,44.3,4,8
164,9,0,98,14,43.7,7,7
164,10,0,94,12,44.1,4,8
164,11,0,115,15,45.9,8,7
164,12,0,92,13,42.8,9,4
164,13,0,66,13,45.4,6,7
164,14,0,60,7,41.4,3,4
164,15,0,118,17,42.7,10,7
164,16,0,113,18,42.6,6,12
164,17,0,131,19,42.9,9,10
164,18,0,85,13,44.2,7,6
164,19,0,106,17,45.9,13,4
164,20,0,58,10,46.3,4,6
164,21,0,72,12,43.5,8,4
164,22,0,102,16,42.8,9,7
164,23,0,85,18,47.6,11,7
164,24,0,102,19,42.5,8,11
164,25,0,93,16,42.3,7,9
164,26,0,92,17,39.4,6,11
164,27,0,71,13,45.0,5,8
164,28,0,72,14,42.7,5,9
164,29,0,80,15,39.6,5,10
164,30,0,106,24,42.6,13,11
165,1,0,96,10,54.8,7,3
165,2,0,101,8,53.6,4,4
165,3,0,102,8,59.9,3,5
165,4,0,97,9,58.4,4,5
165,5,0,104,11,57.2,7,4
165,6,0,60,7,55.6,3,4
165,7,0,48,8,56.6,3,5
165,8,0,99,12,55.9,5,7
165,9,0,100,11,54.5,3,8
165,10,0,114,15,57.8,7,8
165,11,0,116,16,53.2,5,11
165,12,0,106,14,60.0,4,10
165,13,0,74,13,54.2,2,11
165,14,0,73,11,56.7,2,9
165,15,0,92,15,58.4,6,9
165,16,0,88,12,53.9,6,6
165,17,0,90,14,55.7,3,11
165,18,0,106,16,56.6,6,10
165,19,0,113,19,54.4,5,14
165,20,0,63,10,52.6,0,10
165,21,0,63,14,52.9,5,9
165,22,0,110,20,55.9,10,10
165,23,0,99,17,54.1,6,11
165,24,0,113,20,55.8,7,13
165,25,0,113,20,54.4,6,14
165,26,0,113,22,58.5,5,17
165,27,0,67,16,54.1,6,10
165,28,0,54,12,56.8,7,5
165,29,0,100,22,55.2,8,14
165,30,0,87,20,54.0,6,14
166,1,0,136,10,22.4,4,6
166,2,0,96,10,23.5,4,6
166,3,0,116,12,20.1,3,9
166,4,0,102,10,21.4,5,5
166,5,0,126,15,19.3,4,11
166,6,0,59,6,22.4,2,4
166,7,0,63,7,20.9,3,4
166,8,0,63,8,22.6,2,6
166,9,0,93,11,22.0,2,9
166,10,0,94,15,21.7,4,11
166,11,0,101,14,13.8,2,12
166,12,0,109,16,21.3,6,10
166,13,0,52,9,21.8,3,6
166,14,0,76,12,23.3,4,8
166,15,0,110,18,23.4,8,10
166,16,0,88,12,18.9,5,7
166,17,0,93,17,19.4,7,10
166,18,0,118,18,20.5,5,13
166,19,0,115,21,22.3,9,12
166,20,0,73,12,20.7,4,8
166,21,0,62,9,19.7,2,7
166,22,0,85,15,24.9,3,12
166,23,0,99,18,18.8,6,12
166,24,0,122,21,21.2,9,12
166,25,0,111,21,18.2,6,15
166,26,0,84,16,22.1,5,11
166,27,0,62,14,17.8,3,11
166,28,0,64,12,21.1,8,4
166,29,0,86,19,21.5,8,11
166,30,0,97,20,20.4,10,10
167,1,0,41,3,75.8,2,1
167,2,0,3,2,76.2,1,1
167,3,0,26,4,75.0,2,2
167,4,0,23,4,76.6,3,1
167,5,0,6,2,70.5,1,1
167,6,0,19,4,73.1,4,0
167,7,0,28,3,73.7,2,1
167,8,0,33,3,74.3,0,3
167,9,0,10,4,71.7,4,0
167,10,0,23,5,67.9,2,3
167,11,0,5,3,75.9,2,1
167,12,0,29,7,73.5,5,2
167,13,0,14,2,71.8,0,2
167,14,0,27,5,72.8,3,2
167,15,0,34,8,78.2,7,1
167,16,0,20,4,77.0,4,0
167,17,0,35,6,76.3,3,3
167,18,0,7,2,71.3,0,2
167,19,0,29,8,74.8,5,3
167,20,0,0,1,75.8,1,0
167,21,0,0,2,74.6,0,2
167,22,0,41,10,71.8,6,4
167,23,0,28,4,76.3,2,2
167,24,0,4,4,73.5,3,1
167,25,0,7,5,74.3,2,3
167,26,0,0,3,73.4,3,0
167,27,0,16,4,70.3,2,2
167,28,0,13,4,72.3,2,2
167,29,0,23,6,72.7,4,2
167,30,0,19,4,71.3,4,0
168,1,1,104,24,51.8,15,9
168,2,1,84,19,47.8,7,12
168,3,1,80,20,43.1,13,7
168,4,1,97,26,48.3,17,9
168,5,1,72,19,44.4,9,10
168,6,1,58,20,46.8,10,10
168,7,1,65,21,44.9,8,13
168,8,1,82,26,50.1,16,10
168,9,1,81,28,47.7,14,14
168,10,1,112,40,48.1,23,17
168,11,1,79,28,45.5,17,11
168,12,1,82,36,44.3,16,20
168,13,1,58,22,48.2,14,8
168,14,1,63,25,45.2,12,13
168,15,1,83,34,49.3,16,18
168,16,1,87,38,46.1,21,17
168,17,1,75,34,42.7,15,19
168,18,1,81,36,51.0,23,13
168,19,1,80,38,48.3,21,17
168,20,1,64,29,45.7,15,14
168,21,1,48,27,46.8,16,11
168,22,1,106,53,49.7,30,23
168,23,1,88,45,48.6,25,20
168,24,1,91,47,45.5,15,32
168,25,1,73,39,45.8,19,20
168,26,1,95,51,46.6,24,27
168,27,1,39,22,45.2,12,10
168,28,1,50,31,46.5,19,12
168,29,1,66,39,47.3,15,24
168,30,1,78,47,43.5,18,29
169,1,0,36,4,32.9,2,2
169,2,0,37,5,31.5,2,3
169,3,0,25,6,33.9,3,3
169,4,0,39,5,35.3,1,4
169,5,0,16,4,33.9,4,0
169,6,0,17,1,37.7,0,1
169,7,0,21,5,32.7,2,3
169,8,0,29,4,35.9,2,2
169,9,0,22,6,32.1,3,3
169,10,0,34,4,33.1,2,2
169,11,0,6,0,35.0,0,0
169,12,0,36,8,32.8,5,3
169,13,0,10,1,35.1,0,1
169,14,0,27,5,30.5,3,2
169,15,0,17,3,28.2,3,0
169,16,0,8,4,37.0,2,2
169,17,0,32,6,37.6,5,1
169,18,0,28,5,32.9,2,3
169,19,0,23,5,32.3,3,2
169,20,0,6,2,32.3,1,1
169,21,0,6,1,32.5,0,1
169,22,0,53,10,33.1,6,4
169,23,0,27,6,35.2,4,2
169,24,0,40,7,31.0,3,4
169,25,0,6,3,35.5,2,1
169,26,0,5,1,37.1,0,1
169,27,0,10,2,32.8,2,0
169,28,0,19,5,35.6,4,1
169,29,0,51,9,36.6,3,6
169,30,0,25,6,33.8,2,4
170,1,1,140,31,52.9,20,11
170,2,1,122,30,48.7,15,15
170,3,1,117,35,47.1,16,19
170,4,1,124,34,51.8,14,20
170,5,1,95,26,50.5,11,15
170,6,1,68,20,47.3,7,13
170,7,1,78,24,52.1,11,13
170,8,1,133,40,48.3,14,26
170,9,1,131,45,53.0,18,27
170,10,1,114,39,50.9,23,16
170,11,1,127,44,51.1,28,16
170,12,1,156,59,52.4,34,25
170,13,1,77,29,52.6,17,12
170,14,1,77,30,52.7,22,8
170,15,1,122,51,50.9,31,20
170,16,1,101,42,54.9,23,19
170,17,1,114,50,54.7,24,26
170,18,1,138,67,51.7,39,28
170,19,1,76,36,52.3,18,18
170,20,1,93,45,54.0,25,20
170,21,1,84,40,50.6,14,26
170,22,1,124,62,52.6,31,31
170,23,1,102,53,53.7,31,22
170,24,1,127,67,53.5,34,33
170,25,1,115,63,49.9,31,32
170,26,1,119,67,50.7,39,28
170,27,1,77,44,49.8,15,29
170,28,1,73,44,52.3,28,16
170,29,1,138,84,56.4,45,39
170,30,1,117,73,50.5,27,46
171,1,0,118,12,64.0,5,7
171,2,0,109,9,59.4,1,8
171,3,0,133,15,67.1,7,8
171,4,0,110,10,63.6,3,7
171,5,0,118,17,62.7,5,12
171,6,0,69,9,61.1,3,6
171,7,0,90,8,62.8,5,3
171,8,0,128,14,64.0,6,8
171,9,0,99,10,58.8,5,5
171,10,0,110,12,58.8,6,6
171,11,0,80,11,60.7,6,5
171,12,0,103,14,62.3,6,8
171,13,0,94,16,59.9,3,13
171,14,0,80,10,59.6,4,6
171,15,0,102,16,63.3,2,14
171,16,0,115,17,61.9,6,11
171,17,0,120,19,63.4,3,16
171,18,0,102,17,63.8,4,13
171,19,0,108,20,60.9,5,15
171,20,0,69,10,63.6,4,6
171,21,0,83,16,61.4,7,9
171,22,0,103,20,63.2,5,15
171,23,0,120,22,60.5,7,15
171,24,0,114,21,65.7,7,14
171,25,0,102,19,59.2,4,15
171,26,0,131,24,60.3,8,16
171,27,0,66,15,65.1,6,9
171,28,0,81,16,58.9,6,10
171,29,0,108,22,62.6,7,15
171,30,0,106,24,61.0,6,18
172,1,0,19,6,36.7,3,3
172,2,0,28,2,32.5,2,0
172,3,0,32,3,39.6,2,1
172,4,0,40,5,37.5,1,4
172,5,0,22,1,36.4,1,0
172,6,0,13,2,36.9,0,2
172,7,0,44,6,33.4,2,4
172,8,0,21,6,37.2,3,3
172,9,0,24,5,35.1,2,3
172,10,0,14,5,34.0,2,3
172,11,0,39,6,36.2,2,4
172,12,0,5,1,33.1,1,0
172,13,0,31,5,33.9,3,2
172,14,0,28,6,38.1,4,2
172,15,0,60,9,40.5,7,2
172,16,0,42,7,40.4,4,3
172,17,0,39,7,34.1,5,2
172,18,0,4,2,36.9,1,1
172,19,0,15,4,33.6,2,2
172,20,0,29,10,37.9,3,7
172,21,0,17,6,37.7,3,3
172,22,0,25,7,36.6,5,2
172,23,0,8,1,35.4,0,1
172,24,0,25,5,33.4,3,2
172,25,0,18,4,35.6,2,2
172,26,0,31,7,32.3,4,3
172,27,0,39,10,34.0,6,4
172,28,0,9,2,37.5,2,0
172,29,0,21,6,33.7,3,3
172,30,0,0,1,36.9,0,1
173,1,0,81,7,53.5,4,3
173,2,0,115,9,53.5,2,7
173,3,0,115,13,54.4,4,9
173,4,0,105,10,53.7,1,9
173,5,0,89,11,52.8,5,6
173,6,0,84,10,51.9,4,6
173,7,0,68,11,50.7,4,7
173,8,0,83,11,53.7,4,7
173,9,0,90,11,53.3,6,5
173,10,0,108,12,52.7,4,8
173,11,0,90,14,50.5,5,9
173,12,0,109,16,49.0,7,9
173,13,0,84,12,52.4,3,9
173,14,0,66,11,53.2,3,8
173,15,0,98,15,48.5,4,11
173,16,0,110,15,51.1,4,11
173,17,0,92,13,50.8,6,7
173,18,0,119,19,54.3,8,11
173,19,0,91,14,49.6,5,9
173,20,0,59,11,52.3,4,7
173,21,0,81,16,51.7,2,14
173,22,0,84,17,51.7,5,12
173,23,0,106,18,52.2,6,12
173,24,0,86,15,53.3,7,8
173,25,0,117,20,51.1,5,15
173,26,0,75,17,52.5,7,10
173,27,0,67,16,51.7,7,9
173,28,0,81,16,52.0,4,12
173,29,0,115,24,52.4,8,16
173,30,0,124,25,51.8,6,19
174,1,0,33,3,69.7,1,2
174,2,0,24,2,69.6,0,2
174,3,0,68,9,71.6,4,5
174,4,0,50,6,66.2,1,5
174,5,0,75,10,69.7,4,6
174,6,0,51,5,69.1,2,3
174,7,0,28,4,66.9,2,2
174,8,0,49,6,68.1,1,5
174,9,0,52,8,68.6,2,6
174,10,0,52,6,70.6,2,4
174,11,0,51,6,71.4,2,4
174,12,0,102,14,73.7,7,7
174,13,0,46,7,71.1,1,6
174,14,0,36,7,68.9,3,4
174,15,0,59,10,71.5,4,6
174,16,0,62,11,69.6,2,9
174,17,0,46,8,70.5,3,5
174,18,0,40,8,67.3,2,6
174,19,0,67,10,68.5,4,6
174,20,0,34,9,68.5,0,9
174,21,0,41,7,71.0,0,7
174,22,0,54,9,69.7,2,7
174,23,0,27,7,69.9,4,3
174,24,0,78,17,70.5,4,13
174,25,0,58,10,71.6,3,7
174,26,0,56,11,68.7,3,8
174,27,0,36,8,70.6,3,5
174,28,0,56,13,66.8,4,9
174,29,0,52,11,69.3,2,9
174,30,0,38,10,70.1,6,4
175,1,1,66,15,20.3,8,7
175,2,1,40,11,26.0,4,7
175,3,1,40,9,19.4,6,3
175,4,1,24,6,21.7,3,3
175,5,1,62,21,20.6,12,9
175,6,1,50,17,21.5,6,11
175,7,1,29,8,22.0,4,4
175,8,1,26,9,20.1,3,6
175,9,1,49,18,23.4,10,8
175,10,1,39,14,17.6,8,6
175,11,1,43,14,21.5,9,5
175,12,1,7,5,19.4,3,2
175,13,1,23,8,20.2,3,5
175,14,1,21,9,19.7,3,6
175,15,1,45,21,14.5,14,7
175,16,1,58,25,23.2,8,17
175,17,1,82,37,20.7,19,18
175,18,1,50,24,16.6,12,12
175,19,1,55,29,16.6,19,10
175,20,1,33,17,19.6,7,10
175,21,1,34,16,19.9,10,6
175,22,1,31,17,20.3,6,11
175,23,1,53,28,21.6,11,17
175,24,1,34,21,19.8,9,12
175,25,1,23,14,18.3,5,9
175,26,1,42,23,21.5,14,9
175,27,1,21,12,17.6,6,6
175,28,1,42,26,17.9,11,15
175,29,1,13,11,22.2,8,3
175,30,1,53,35,21.4,15,20
176,1,0,73,6,74.0,4,2
176,2,0,83,6,80.0,1,5
176,3,0,82,9,74.7,5,4
176,4,0,57,4,73.6,2,2
176,5,0,71,10,77.5,6,4
176,6,0,40,5,74.7,3,2
176,7,0,57,5,80.1,1,4
176,8,0,55,7,82.0,4,3
176,9,0,43,8,77.9,4,4
176,10,0,50,8,76.2,6,2
176,11,0,55,10,75.8,6,4
176,12,0,67,9,77.4,4,5
176,13,0,43,7,79.4,4,3
176,14,0,52,10,76.9,6,4
176,15,0,66,8,72.1,4,4
176,16,0,84,11,79.4,7,4
176,17,0,53,10,79.0,7,3
176,18,0,61,11,75.2,7,4
176,19,0,44,8,75.4,1,7
176,20,0,37,6,78.6,2,4
176,21,0,55,9,72.5,5,4
176,22,0,42,8,79.0,3,5
176,23,0,78,13,75.4,5,8
176,24,0,72,14,79.3,6,8
176,25,0,48,10,76.5,2,8
176,26,0,39,8,77.6,2,6
176,27,0,40,10,75.9,4,6
176,28,0,45,9,76.9,3,6
176,29,0,87,19,77.9,11,8
176,30,0,86,19,74.8,4,15
177,1,0,70,5,73.4,2,3
177,2,0,55,7,69.5,3,4
177,3,0,66,5,71.4,4,1
177,4,0,50,4,71.9,2,2
177,5,0,56,7,74.2,1,6
177,6,0,50,8,73.1,3,5
177,7,0,15,3,75.3,0,3
177,8,0,63,9,73.2,3,6
177,9,0,66,9,73.3,3,6
177,10,0,68,8,72.7,4,4
177,11,0,90,11,74.6,5,6
177,12,0,70,9,74.1,4,5
177,13,0,29,4,72.5,2,2
177,14,0,41,8,72.0,5,3
177,15,0,54,9,70.6,2,7
177,16,0,38,6,72.1,3,3
177,17,0,101,17,72.2,12,5
177,18,0,41,9,72.7,3,6
177,19,0,53,10,73.9,4,6
177,20,0,28,6,73.9,4,2
177,21,0,35,6,73.5,2,4
177,22,0,46,9,75.3,5,4
177,23,0,74,14,74.7,3,11
177,24,0,68,14,73.1,7,7
177,25,0,62,15,71.7,6,9
177,26,0,51,13,74.6,10,3
177,27,0,33,7,75.9,4,3
177,28,0,44,12,75.1,7,5
177,29,0,77,15,72.8,6,9
177,30,0,66,17,76.0,9,8
178,1,0,69,5,65.0,2,3
178,2,0,33,3,66.2,0,3
178,3,0,39,3,62.0,2,1
178,4,0,60,5,63.5,2,3
178,5,0,9,0,61.5,0,0
178,6,0,51,4,61.7,1,3
178,7,0,52,7,60.3,3,4
178,8,0,30,8,65.6,2,6
178,9,0,69,8,61.7,5,3
178,10,0,55,8,67.2,3,5
178,11,0,59,12,62.9,5,7
178,12,0,36,10,64.9,2,8
178,13,0,52,6,65.5,2,4
178,14,0,31,5,64.8,1,4
178,15,0,72,10,57.0,3,7
178,16,0,36,5,66.8,2,3
178,17,0,60,9,62.8,3,6
178,18,0,70,11,61.0,4,7
178,19,0,61,10,62.8,2,8
178,20,0,40,8,61.3,3,5
178,21,0,38,8,66.6,2,6
178,22,0,52,11,67.7,7,4
178,23,0,52,10,64.4,4,6
178,24,0,38,10,65.7,3,7
178,25,0,36,7,59.9,4,3
178,26,0,37,9,63.0,4,5
178,27,0,53,10,63.7,3,7
178,28,0,43,11,64.2,4,7
178,29,0,38,9,60.9,2,7
178,30,0,57,12,66.1,3,9
179,1,0,49,5,37.0,3,2
179,2,0,69,6,35.6,5,1
179,3,0,50,5,37.3,4,1
179,4,0,80,10,33.5,5,5
179,5,0,68,7,35.1,6,1
179,6,0,42,5,36.9,5,0
179,7,0,36,6,35.7,3,3
179,8,0,67,8,33.5,3,5
179,9,0,62,9,34.3,7,2
179,10,0,62,7,36.1,4,3
179,11,0,46,7,35.3,4,3
179,12,0,61,10,37.9,8,2
179,13,0,42,7,37.3,4,3
179,14,0,47,7,33.9,4,3
179,15,0,49,7,33.5,6,1
179,16,0,13,2,35.0,0,2
179,17,0,70,9,36.2,6,3
179,18,0,64,12,34.3,7,5
179,19,0,52,9,34.5,4,5
179,20,0,51,8,33.0,5,3
179,21,0,27,6,34.5,1,5
179,22,0,46,7,35.5,4,3
179,23,0,61,16,35.1,9,7
179,24,0,54,11,31.9,4,7
179,25,0,40,7,37.4,5,2
179,26,0,82,15,35.7,11,4
179,27,0,29,8,34.5,7,1
179,28,0,48,9,34.7,8,1
179,29,0,41,11,34.7,8,3
179,30,0,58,15,36.2,14,1
180,1,1,57,12,67.4,8,4
180,2,1,59,13,71.8,7,6
180,3,1,35,10,66.2,6,4
180,4,1,98,25,71.3,14,11
180,5,1,68,24,70.4,15,9
180,6,1,42,12,70.6,4,8
180,7,1,59,17,70.1,5,12
180,8,1,96,31,64.8,12,19
180,9,1,74,23,68.0,13,10
180,10,1,62,23,67.0,12,11
180,11,1,53,21,66.1,8,13
180,12,1,83,31,69.8,17,14
180,13,1,59,25,69.5,11,14
180,14,1,60,27,67.7,10,17
180,15,1,68,29,68.7,8,21
180,16,1,92,39,69.6,21,18
180,17,1,72,30,68.5,19,11
180,18,1,73,35,68.0,14,21
180,19,1,86,41,67.8,22,19
180,20,1,68,34,65.8,16,18
180,21,1,62,29,68.1,17,12
180,22,1,82,41,68.6,16,25
180,23,1,68,34,66.6,15,19
180,24,1,56,34,70.0,17,17
180,25,1,73,39,70.6,25,14
180,26,1,81,49,67.5,25,24
180,27,1,48,30,72.4,21,9
180,28,1,35,21,69.8,9,12
180,29,1,54,32,66.2,10,22
180,30,1,74,45,69.2,24,21
181,1,1,51,13,25.9,5,8
181,2,1,58,13,25.7,6,7
181,3,1,37,10,26.4,5,5
181,4,1,27,9,31.8,3,6
181,5,1,59,19,28.6,10,9
181,6,1,46,12,27.0,6,6
181,7,1,40,14,26.8,4,10
181,8,1,31,12,29.4,5,7
181,9,1,37,13,27.1,10,3
181,10,1,31,12,28.0,6,6
181,11,1,75,26,24.7,11,15
181,12,1,51,20,26.9,10,10
181,13,1,36,14,28.0,5,9
181,14,1,53,23,25.9,15,8
181,15,1,46,20,22.9,11,9
181,16,1,63,27,29.1,12,15
181,17,1,73,32,23.0,10,22
181,18,1,54,23,26.9,10,13
181,19,1,51,25,26.9,16,9
181,20,1,40,20,27.1,9,11
181,21,1,32,16,27.2,8,8
181,22,1,36,17,31.1,9,8
181,23,1,59,32,26.3,20,12
181,24,1,45,25,26.9,10,15
181,25,1,51,31,28.5,21,10
181,26,1,27,17,24.4,8,9
181,27,1,57,31,26.2,16,15
181,28,1,19,11,25.1,6,5
181,29,1,58,39,25.6,17,22
181,30,1,54,34,26.7,18,16
182,1,0,88,7,64.4,1,6
182,2,0,110,11,62.5,4,7
182,3,0,90,9,65.5,4,5
182,4,0,81,10,64.6,1,9
182,5,0,67,7,68.1,2,5
182,6,0,62,5,65.2,0,5
182,7,0,64,9,64.1,5,4
182,8,0,87,9,66.4,4,5
182,9,0,80,10,66.7,4,6
182,10,0,80,11,64.0,2,9
182,11,0,105,15,64.7,8,7
182,12,0,78,12,62.6,9,3
182,13,0,78,13,65.0,3,10
182,14,0,57,8,62.1,3,5
182,15,0,101,13,57.7,3,10
182,16,0,83,14,61.7,8,6
182,17,0,93,16,63.9,11,5
182,18,0,99,14,66.4,6,8
182,19,0,59,8,68.3,3,5
182,20,0,61,9,65.3,2,7
182,21,0,65,13,64.5,2,11
182,22,0,81,18,66.3,3,15
182,23,0,78,16,64.4,8,8
182,24,0,88,15,66.6,4,11
182,25,0,59,11,66.4,4,7
182,26,0,67,15,67.0,6,9
182,27,0,65,12,63.4,2,10
182,28,0,50,12,64.9,3,9
182,29,0,92,19,62.9,9,10
182,30,0,74,17,63.9,5,12
183,1,0,22,2,71.9,0,2
183,2,0,8,1,75.5,0,1
183,3,0,13,4,74.3,4,0
183,4,0,0,1,75.1,0,1
183,5,0,0,3,73.2,3,0
183,6,0,0,5,68.6,1,4
183,7,0,19,2,74.8,0,2
183,8,0,24,2,73.1,0,2
183,9,0,7,1,75.7,0,1
183,10,0,28,7,70.6,3,4
183,11,0,32,4,75.6,4,0
183,12,0,24,2,77.8,0,2
183,13,0,26,7,72.8,4,3
183,14,0,0,6,72.4,3,3
183,15,0,25,5,71.8,4,1
183,16,0,0,1,76.5,1,0
183,17,0,25,5,71.0,2,3
183,18,0,3,0,74.6,0,0
183,19,0,46,7,71.7,3,4
183,20,0,0,1,75.2,0,1
183,21,0,18,6,72.4,3,3
183,22,0,19,3,71.0,1,2
183,23,0,42,8,72.7,7,1
183,24,0,30,7,73.4,2,5
183,25,0,13,5,74.9,4,1
183,26,0,16,4,70.0,1,3
183,27,0,20,3,73.9,2,1
183,28,0,17,5,73.5,2,3
183,29,0,39,8,74.7,1,7
183,30,0,38,11,74.1,6,5
184,1,0,55,4,69.3,4,0
184,2,0,74,6,70.0,3,3
184,3,0,47,7,67.5,2,5
184,4,0,62,5,67.3,3,2
184,5,0,53,5,69.6,2,3
184,6,0,47,7,72.6,2,5
184,7,0,49,7,69.7,3,4
184,8,0,56,8,66.5,3,5
184,9,0,84,11,69.1,9,2
184,10,0,74,9,68.7,3,6
184,11,0,55,6,69.5,3,3
184,12,0,61,11,64.5,5,6
184,13,0,44,9,68.7,7,2
184,14,0,65,8,67.2,6,2
184,15,0,78,12,72.1,5,7
184,16,0,58,8,69.9,3,5
184,17,0,85,13,69.1,6,7
184,18,0,52,8,70.9,4,4
184,19,0,77,11,71.9,6,5
184,20,0,14,6,69.3,5,1
184,21,0,39,9,66.4,5,4
184,22,0,67,13,67.3,5,8
184,23,0,52,9,68.6,4,5
184,24,0,63,11,66.2,7,4
184,25,0,75,14,65.7,4,10
184,26,0,46,9,68.7,3,6
184,27,0,38,8,71.3,4,4
184,28,0,61,12,70.6,4,8
184,29,0,71,16,65.0,7,9
184,30,0,38,8,67.8,4,4
185,1,0,59,7,76.5,4,3
185,2,0,61,7,81.3,4,3
185,3,0,55,7,79.6,7,0
185,4,0,59,5,82.6,4,1
185,5,0,69,10,84.3,9,1
185,6,0,45,4,80.3,3,1
185,7,0,58,8,80.0,3,5
185,8,0,59,6,80.6,3,3
185,9,0,63,6,80.7,4,2
185,10,0,60,9,81.6,7,2
185,11,0,65,10,81.3,7,3
185,12,0,72,9,80.5,4,5
185,13,0,51,6,79.1,3,3
185,14,0,30,4,78.7,1,3
185,15,0,60,13,80.3,7,6
185,16,0,70,9,82.3,4,5
185,17,0,62,12,78.8,3,9
185,18,0,79,12,78.8,9,3
185,19,0,79,15,79.3,10,5
185,20,0,62,12,81.3,12,0
185,21,0,61,10,75.8,5,5
185,22,0,81,14,82.1,10,4
185,23,0,44,11,83.5,6,5
185,24,0,66,11,80.3,7,4
185,25,0,58,16,78.9,13,3
185,26,0,81,17,80.5,10,7
185,27,0,48,11,82.1,8,3
185,28,0,68,14,81.1,7,7
185,29,0,70,14,78.7,6,8
185,30,0,50,13,83.1,10,3
186,1,0,75,8,63.1,7,1
186,2,0,67,5,57.5,4,1
186,3,0,76,8,61.3,7,1
186,4,0,87,10,58.7,7,3
186,5,0,62,9,57.9,8,1
186,6,0,62,5,59.5,4,1
186,7,0,36,4,59.5,3,1
186,8,0,69,10,58.9,9,1
186,9,0,89,9,55.6,6,3
186,10,0,97,11,59.0,8,3
186,11,0,70,13,51.9,5,8
186,12,0,85,13,59.6,8,5
186,13,0,77,9,57.5,5,4
186,14,0,73,12,59.1,9,3
186,15,0,66,10,51.9,5,5
186,16,0,64,8,58.2,7,1
186,17,0,89,14,59.6,8,6
186,18,0,98,16,60.4,9,7
186,19,0,48,11,57.3,5,6
186,20,0,38,7,61.0,4,3
186,21,0,59,12,52.8,7,5
186,22,0,67,12,54.4,7,5
186,23,0,95,17,59.3,11,6
186,24,0,75,14,59.1,9,5
186,25,0,95,20,58.9,16,4
186,26,0,68,13,61.3,4,9
186,27,0,43,8,56.6,3,5
186,28,0,55,11,59.0,9,2
186,29,0,71,15,58.7,12,3
186,30,0,87,20,55.6,11,9
187,1,0,66,5,78.0,3,2
187,2,0,46,6,78.4,1,5
187,3,0,24,5,79.4,3,2
187,4,0,63,7,76.6,4,3
187,5,0,29,6,80.4,2,4
187,6,0,31,6,78.5,3,3
187,7,0,32,5,74.9,3,2
187,8,0,56,7,75.0,3,4
187,9,0,64,10,75.7,4,6
187,10,0,40,7,78.1,3,4
187,11,0,65,7,79.7,3,4
187,12,0,57,6,78.6,2,4
187,13,0,39,4,77.1,2,2
187,14,0,16,4,78.2,3,1
187,15,0,30,8,66.7,3,5
187,16,0,59,9,76.3,4,5
187,17,0,43,9,78.5,5,4
187,18,0,54,9,72.9,3,6
187,19,0,65,12,77.5,6,6
187,20,0,25,4,76.1,2,2
187,21,0,36,5,78.8,4,1
187,22,0,61,11,76.0,5,6
187,23,0,41,7,79.4,4,3
187,24,0,37,11,76.0,5,6
187,25,0,52,11,79.5,6,5
187,26,0,76,14,79.6,8,6
187,27,0,44,10,74.7,6,4
187,28,0,38,8,74.2,5,3
187,29,0,45,11,78.6,7,4
187,30,0,26,8,75.9,4,4
188,1,0,133,10,25.3,5,5
188,2,0,141,10,26.1,4,6
188,3,0,126,13,28.9,7,6
188,4,0,120,11,22.4,3,8
188,5,0,93,9,24.1,2,7
188,6,0,86,12,20.8,2,10
188,7,0,93,13,24.2,7,6
188,8,0,107,11,21.7,4,7
188,9,0,114,15,22.6,1,14
188,10,0,135,15,18.4,5,10
188,11,0,78,9,26.0,5,4
188,12,0,135,17,21.0,9,8
188,13,0,78,13,26.9,4,9
188,14,0,84,10,19.9,5,5
188,15,0,109,18,33.7,7,11
188,16,0,117,17,22.9,5,12
188,17,0,134,23,23.1,8,15
188,18,0,121,18,21.5,8,10
188,19,0,109,18,22.0,6,12
188,20,0,84,15,26.4,5,10
188,21,0,84,13,26.9,5,8
188,22,0,110,20,20.2,8,12
188,23,0,79,13,21.6,3,10
188,24,0,105,19,20.2,4,15
188,25,0,123,25,17.0,5,20
188,26,0,117,22,27.8,7,15
188,27,0,96,21,21.0,7,14
188,28,0,78,16,21.8,6,10
188,29,0,93,20,26.5,7,13
188,30,0,97,20,24.3,3,17
189,1,0,78,8,32.9,5,3
189,2,0,76,8,28.6,5,3
189,3,0,77,7,24.2,2,5
189,4,0,74,8,25.9,4,4
189,5,0,84,9,28.0,8,1
189,6,0,43,8,28.3,4,4
189,7,0,51,6,28.0,3,3
189,8,0,77,9,24.9,7,2
189,9,0,85,10,28.2,7,3
189,10,0,68,9,26.5,5,4
189,11,0,83,12,25.2,9,3
189,12,0,59,7,25.4,5,2
189,13,0,66,10,28.0,6,4
189,14,0,64,10,26.9,6,4
189,15,0,61,8,22.4,6,2
189,16,0,67,10,28.0,6,4
189,17,0,90,12,30.1,11,1
189,18,0,76,13,31.3,8,5
189,19,0,78,13,25.2,8,5
189,20,0,43,8,32.6,5,3
189,21,0,55,8,27.6,5,3
189,22,0,68,13,24.0,8,5
189,23,0,68,14,25.9,11,3
189,24,0,66,14,25.9,6,8
189,25,0,70,12,26.4,8,4
189,26,0,72,16,25.5,8,8
189,27,0,49,9,25.9,8,1
189,28,0,60,13,30.9,10,3
189,29,0,70,14,25.1,10,4
189,30,0,72,15,27.6,10,5
190,1,0,10,3,54.4,2,1
190,2,0,37,5,54.8,2,3
190,3,0,42,3,58.2,3,0
190,4,0,33,4,52.7,4,0
190,5,0,54,7,60.2,4,3
190,6,0,31,4,59.9,4,0
190,7,0,31,7,56.7,3,4
190,8,0,41,6,50.5,5,1
190,9,0,38,7,53.0,5,2
190,10,0,14,2,57.2,1,1
190,11,0,24,3,57.1,2,1
190,12,0,24,7,53.9,3,4
190,13,0,20,5,60.5,5,0
190,14,0,15,4,56.1,2,2
190,15,0,45,8,54.0,8,0
190,16,0,25,5,51.4,3,2
190,17,0,30,7,55.9,3,4
190,18,0,44,9,57.6,7,2
190,19,0,62,10,56.1,8,2
190,20,0,31,6,56.5,4,2
190,21,0,17,6,55.7,6,0
190,22,0,26,6,49.6,5,1
190,23,0,50,12,57.7,8,4
190,24,0,20,5,57.8,3,2
190,25,0,31,7,59.9,5,2
190,26,0,30,8,59.2,6,2
190,27,0,11,3,56.2,2,1
190,28,0,31,6,58.8,3,3
190,29,0,28,5,59.9,3,2
190,30,0,40,10,57.1,4,6
191,1,0,104,11,23.4,5,6
191,2,0,142,14,27.2,7,7
191,3,0,127,12,24.8,1,11
191,4,0,102,11,24.7,5,6
191,5,0,107,11,25.4,2,9
191,6,0,74,7,26.5,0,7
191,7,0,83,13,27.5,7,6
191,8,0,140,16,26.0,7,9
191,9,0,99,14,28.0,5,9
191,10,0,111,12,25.4,7,5
191,11,0,87,14,24.9,4,10
191,12,0,140,17,26.7,4,13
191,13,0,98,15,25.2,5,10
191,14,0,91,11,29.3,6,5
191,15,0,119,15,30.6,5,10
191,16,0,96,15,26.4,6,9
191,17,0,123,18,23.6,6,12
191,18,0,99,14,23.7,4,10
191,19,0,150,23,26.6,7,16
191,20,0,88,15,27.8,8,7
191,21,0,97,18,24.6,6,12
191,22,0,110,21,26.2,8,13
191,23,0,105,17,26.6,7,10
191,24,0,126,23,24.7,5,18
191,25,0,111,21,26.1,4,17
191,26,0,99,19,27.2,8,11
191,27,0,86,21,26.0,10,11
191,28,0,79,17,23.7,5,12
191,29,0,127,27,25.4,10,17
191,30,0,125,26,28.0,10,16
192,1,0,94,7,51.4,5,2
192,2,0,103,9,54.5,6,3
192,3,0,129,13,54.8,7,6
192,4,0,72,9,52.2,6,3
192,5,0,80,9,50.4,6,3
192,6,0,69,11,56.3,8,3
192,7,0,89,10,52.9,7,3
192,8,0,92,10,53.6,6,4
192,9,0,121,13,56.8,8,5
192,10,0,80,10,53.5,9,1
192,11,0,103,11,53.0,6,5
192,12,0,109,16,51.1,6,10
192,13,0,74,11,55.4,4,7
192,14,0,95,14,52.2,9,5
192,15,0,93,14,44.8,7,7
192,16,0,128,21,54.5,14,7
192,17,0,113,18,54.4,11,7
192,18,0,108,15,53.7,14,1
192,19,0,103,16,50.6,11,5
192,20,0,82,13,48.7,9,4
192,21,0,81,14,52.7,8,6
192,22,0,111,21,54.8,16,5
192,23,0,93,16,51.9,13,3
192,24,0,102,18,55.2,9,9
192,25,0,102,20,53.0,13,7
192,26,0,107,20,54.1,14,6
192,27,0,75,15,51.7,9,6
192,28,0,89,18,52.6,9,9
192,29,0,108,24,54.3,15,9
192,30,0,103,24,50.5,9,15
193,1,0,74,6,67.6,2,4
193,2,0,47,5,67.5,2,3
193,3,0,81,10,64.9,2,8
193,4,0,78,10,67.2,2,8
193,5,0,84,9,68.5,1,8
193,6,0,66,7,70.3,5,2
193,7,0,60,9,70.7,6,3
193,8,0,98,12,68.3,5,7
193,9,0,81,19,66.2,13,6
193,10,0,74,11,70.5,8,3
193,11,0,91,12,70.2,5,7
193,12,0,74,9,67.4,6,3
193,13,0,40,4,67.7,2,2
193,14,0,37,6,64.5,3,3
193,15,0,74,10,62.5,4,6
193,16,0,87,14,71.3,7,7
193,17,0,88,13,65.8,3,10
193,18,0,61,10,66.8,2,8
193,19,0,107,18,71.7,6,12
193,20,0,58,12,66.9,6,6
193,21,0,72,14,66.2,6,8
193,22,0,70,17,66.2,7,10
193,23,0,124,21,68.4,9,12
193,24,0,101,19,69.6,13,6
193,25,0,112,19,69.7,9,10
193,26,0,107,21,66.3,9,12
193,27,0,60,12,67.1,6,6
193,28,0,60,12,66.6,5,7
193,29,0,113,24,70.1,13,11
193,30,0,106,26,65.0,11,15
194,1,0,36,7,41.2,3,4
194,2,0,47,4,40.8,3,1
194,3,0,42,5,42.1,3,2
194,4,0,50,6,43.8,4,2
194,5,0,21,4,42.4,3,1
194,6,0,19,2,39.8,1,1
194,7,0,35,5,37.4,3,2
194,8,0,39,4,42.6,1,3
194,9,0,18,3,37.9,1,2
194,10,0,33,4,40.5,4,0
194,11,0,23,3,39.6,1,2
194,12,0,18,3,37.8,2,1
194,13,0,6,2,39.4,1,1
194,14,0,32,6,44.7,4,2
194,15,0,31,7,41.3,4,3
194,16,0,40,7,39.4,4,3
194,17,0,35,7,38.1,5,2
194,18,0,31,6,38.5,2,4
194,19,0,53,8,40.8,6,2
194,20,0,32,5,40.2,4,1
194,21,0,34,8,39.8,4,4
194,22,0,53,13,38.8,8,5
194,23,0,54,12,41.1,6,6
194,24,0,31,8,39.5,5,3
194,25,0,45,10,42.1,9,1
194,26,0,43,10,38.9,6,4
194,27,0,47,14,41.7,10,4
194,28,0,16,5,40.5,4,1
194,29,0,35,9,39.5,7,2
194,30,0,55,14,36.5,9,5
195,1,0,123,11,34.0,5,6
195,2,0,111,13,27.7,7,6
195,3,0,117,11,28.8,4,7
195,4,0,94,9,30.8,4,5
195,5,0,84,8,30.9,6,2
195,6,0,100,13,32.2,9,4
195,7,0,89,11,31.2,9,2
195,8,0,125,12,28.5,7,5
195,9,0,106,12,34.4,3,9
195,10,0,114,16,30.5,8,8
195,11,0,122,14,32.1,6,8
195,12,0,111,14,28.9,9,5
195,13,0,64,9,30.8,3,6
195,14,0,82,12,32.2,6,6
195,15,0,109,16,35.9,11,5
195,16,0,92,12,33.5,5,7
195,17,0,102,21,29.2,12,9
195,18,0,123,20,26.7,10,10
195,19,0,124,22,33.1,14,8
195,20,0,81,15,29.4,7,8
195,21,0,68,11,31.9,6,5
195,22,0,111,20,31.5,6,14
195,23,0,106,22,27.3,11,11
195,24,0,89,22,31.5,13,9
195,25,0,108,23,29.0,14,9
195,26,0,109,23,32.8,13,10
195,27,0,72,16,32.1,7,9
195,28,0,87,18,30.7,11,7
195,29,0,134,26,30.2,13,13
195,30,0,93,20,31.6,7,13
196,1,1,90,22,33.6,10,12
196,2,1,58,16,31.1,10,6
196,3,1,62,16,26.2,6,10
196,4,1,52,16,33.6,10,6
196,5,1,53,17,29.1,9,8
196,6,1,42,12,33.4,10,2
196,7,1,40,14,29.8,9,5
196,8,1,72,25,33.2,16,9
196,9,1,84,29,33.2,21,8
196,10,1,39,17,33.8,9,8
196,11,1,66,25,31.4,11,14
196,12,1,49,19,30.3,12,7
196,13,1,41,17,30.3,7,10
196,14,1,37,16,33.4,8,8
196,15,1,75,30,27.6,13,17
196,16,1,49,21,29.2,14,7
196,17,1,78,33,32.9,15,18
196,18,1,50,23,30.4,11,12
196,19,1,55,24,29.7,11,13
196,20,1,33,17,30.5,9,8
196,21,1,45,22,37.3,13,9
196,22,1,62,32,31.7,13,19
196,23,1,48,28,32.7,15,13
196,24,1,39,20,31.4,11,9
196,25,1,77,41,33.9,22,19
196,26,1,42,22,32.1,6,16
196,27,1,42,24,29.7,12,12
196,28,1,45,27,28.6,15,12
196,29,1,68,39,34.6,20,19
196,30,1,73,44,30.7,24,20
197,1,1,80,18,73.7,10,8
197,2,1,103,24,73.3,14,10
197,3,1,85,22,75.4,13,9
197,4,1,64,17,72.2,10,7
197,5,1,107,30,73.9,15,15
197,6,1,82,25,76.3,12,13
197,7,1,78,22,76.3,9,13
197,8,1,89,27,76.4,15,12
197,9,1,89,29,74.8,14,15
197,10,1,104,37,73.7,20,17
197,11,1,99,34,74.5,17,17
197,12,1,119,43,75.4,17,26
197,13,1,67,27,72.8,16,11
197,14,1,69,29,78.2,17,12
197,15,1,123,50,73.3,21,29
197,16,1,87,38,75.3,19,19
197,17,1,98,44,73.2,20,24
197,18,1,98,45,76.1,27,18
197,19,1,123,55,75.2,25,30
197,20,1,86,41,75.0,23,18
197,21,1,76,36,76.5,18,18
197,22,1,61,30,77.9,16,14
197,23,1,113,59,76.7,23,36
197,24,1,87,48,78.4,25,23
197,25,1,131,71,77.7,38,33
197,26,1,98,57,77.7,26,31
197,27,1,89,50,75.7,25,25
197,28,1,71,42,75.8,20,22
197,29,1,116,69,75.0,29,40
197,30,1,130,79,74.6,35,44
198,1,0,83,7,73.1,0,7
198,2,0,114,9,72.4,3,6
198,3,0,109,8,71.4,5,3
198,4,0,93,7,71.4,2,5
198,5,0,75,9,68.6,6,3
198,6,0,65,7,72.2,4,3
198,7,0,71,7,73.4,3,4
198,8,0,104,14,69.8,7,7
198,9,0,103,13,72.9,5,8
198,10,0,97,11,72.2,5,6
198,11,0,76,10,72.8,6,4
198,12,0,81,9,75.0,8,1
198,13,0,78,10,72.5,6,4
198,14,0,71,9,72.4,5,4
198,15,0,104,15,71.8,8,7
198,16,0,109,16,72.9,7,9
198,17,0,79,12,74.7,5,7
198,18,0,99,14,73.6,9,5
198,19,0,113,18,72.0,4,14
198,20,0,74,16,76.5,8,8
198,21,0,67,10,71.5,3,7
198,22,0,90,15,73.8,10,5
198,23,0,92,18,73.7,9,9
198,24,0,68,13,72.8,6,7
198,25,0,94,16,72.5,10,6
198,26,0,102,18,71.6,9,9
198,27,0,56,12,73.7,8,4
198,28,0,70,14,73.8,8,6
198,29,0,109,22,77.4,12,10
198,30,0,91,21,73.1,13,8
199,1,0,12,2,70.8,1,1
199,2,0,25,3,76.1,2,1
199,3,0,9,2,76.9,1,1
199,4,0,11,1,69.0,0,1
199,5,0,0,3,73.0,1,2
199,6,0,0,3,72.4,0,3
199,7,0,7,3,73.7,1,2
199,8,0,0,1,73.5,1,0
199,9,0,0,3,73.2,1,2
199,10,0,8,4,77.3,2,2
199,11,0,27,4,77.2,1,3
199,12,0,25,5,71.5,2,3
199,13,0,14,4,72.9,2,2
199,14,0,0,5,71.0,2,3
199,15,0,10,4,77.4,1,3
199,16,0,2,1,74.0,0,1
199,17,0,28,4,76.1,2,2
199,18,0,40,9,71.1,4,5
199,19,0,9,3,71.1,1,2
199,20,0,0,2,71.1,1,1
199,21,0,9,6,75.9,1,5
199,22,0,0,3,72.4,1,2
199,23,0,0,4,76.3,3,1
199,24,0,14,5,73.8,1,4
199,25,0,41,8,74.6,5,3
199,26,0,7,4,73.5,1,3
199,27,0,12,3,69.4,1,2
199,28,0,17,5,72.2,2,3
199,29,0,3,1,74.3,1,0
199,30,0,0,1,74.4,0,1
200,1,1,105,23,74.2,8,15
200,2,1,116,29,74.7,18,11
200,3,1,92,26,74.8,12,14
200,4,1,129,36,77.2,19,17
200,5,1,119,35,73.5,17,18
200,6,1,84,25,77.4,14,11
200,7,1,86,28,78.9,13,15
200,8,1,103,33,71.8,13,20
200,9,1,131,45,79.1,20,25
200,10,1,97,33,72.1,14,19
200,11,1,125,46,76.3,18,28
200,12,1,93,35,74.4,25,10
200,13,1,72,27,73.2,10,17
200,14,1,63,24,75.5,13,11
200,15,1,103,43,79.8,20,23
200,16,1,112,47,76.6,24,23
200,17,1,107,46,72.9,24,22
200,18,1,88,40,77.6,13,27
200,19,1,127,61,75.6,23,38
200,20,1,93,44,71.8,14,30
200,21,1,87,41,72.7,17,24
200,22,1,113,57,75.6,21,36
200,23,1,125,66,80.4,46,20
200,24,1,121,63,72.8,39,24
200,25,1,104,57,76.5,37,20
200,26,1,156,87,79.3,44,43
200,27,1,89,52,73.1,18,34
200,28,1,65,40,71.0,16,24
200,29,1,101,59,76.1,29,30
200,30,1,137,85,71.3,41,44
201,1,0,64,7,39.1,3,4
201,2,0,59,7,42.2,4,3
201,3,0,59,7,40.2,6,1
201,4,0,81,10,40.3,7,3
201,5,0,78,8,37.1,5,3
201,6,0,40,4,38.8,0,4
201,7,0,40,6,37.1,3,3
201,8,0,70,8,39.1,3,5
201,9,0,74,9,42.6,4,5
201,10,0,71,10,39.7,4,6
201,11,0,44,7,37.2,2,5
201,12,0,84,12,37.8,7,5
201,13,0,60,8,41.8,5,3
201,14,0,55,10,38.6,4,6
201,15,0,72,11,42.6,4,7
201,16,0,100,16,35.6,6,10
201,17,0,70,10,41.0,8,2
201,18,0,78,14,38.5,6,8
201,19,0,69,12,40.2,4,8
201,20,0,41,9,43.5,4,5
201,21,0,40,10,37.3,6,4
201,22,0,76,13,40.9,8,5
201,23,0,67,15,38.1,6,9
201,24,0,62,11,36.9,6,5
201,25,0,95,18,38.7,7,11
201,26,0,55,12,40.2,7,5
201,27,0,47,13,37.2,6,7
201,28,0,62,13,38.2,8,5
201,29,0,60,13,41.8,5,8
201,30,0,39,10,40.8,1,9
202,1,0,43,5,48.2,1,4
202,2,0,60,6,51.2,2,4
202,3,0,56,8,49.0,2,6
202,4,0,0,1,50.5,0,1
202,5,0,59,6,47.8,1,5
202,6,0,37,6,45.7,1,5
202,7,0,29,5,48.1,4,1
202,8,0,47,6,49.6,1,5
202,9,0,76,9,52.5,1,8
202,10,0,29,4,49.0,1,3
202,11,0,52,9,47.6,3,6
202,12,0,53,9,48.8,3,6
202,13,0,23,4,49.6,0,4
202,14,0,29,5,47.9,2,3
202,15,0,66,9,53.8,3,6
202,16,0,42,6,51.0,4,2
202,17,0,47,8,47.5,4,4
202,18,0,63,13,50.6,3,10
202,19,0,46,7,48.3,4,3
202,20,0,35,7,48.8,1,6
202,21,0,23,4,49.5,3,1
202,22,0,53,11,47.2,2,9
202,23,0,53,13,50.3,0,13
202,24,0,28,6,50.1,1,5
202,25,0,23,5,53.3,3,2
202,26,0,41,8,50.1,1,7
202,27,0,26,5,53.1,2,3
202,28,0,32,9,47.8,1,8
202,29,0,28,7,50.7,0,7
202,30,0,36,11,49.8,4,7
203,1,0,92,8,49.8,6,2
203,2,0,49,5,48.6,0,5
203,3,0,74,9,45.7,6,3
203,4,0,95,9,43.1,8,1
203,5,0,74,9,47.8,7,2
203,6,0,52,4,50.0,2,2
203,7,0,53,7,47.3,4,3
203,8,0,58,8,46.6,5,3
203,9,0,74,7,47.0,6,1
203,10,0,87,11,49.1,8,3
203,11,0,80,10,47.7,5,5
203,12,0,85,11,46.9,10,1
203,13,0,38,6,48.0,5,1
203,14,0,55,10,47.4,7,3
203,15,0,85,13,44.5,9,4
203,16,0,62,11,48.4,9,2
203,17,0,72,14,46.7,8,6
203,18,0,55,10,46.3,3,7
203,19,0,74,12,48.8,7,5
203,20,0,57,10,44.9,5,5
203,21,0,53,9,44.4,6,3
203,22,0,94,17,47.0,13,4
203,23,0,76,13,48.3,8,5
203,24,0,43,11,46.4,5,6
203,25,0,69,13,45.9,7,6
203,26,0,64,14,46.7,10,4
203,27,0,63,11,45.3,8,3
203,28,0,57,13,47.1,8,5
203,29,0,94,19,46.6,12,7
203,30,0,104,23,47.2,14,9
204,1,0,14,3,22.5,2,1
204,2,0,7,4,19.2,3,1
204,3,0,0,0,19.6,0,0
204,4,0,9,2,20.4,1,1
204,5,0,14,5,25.8,4,1
204,6,0,11,3,26.1,1,2
204,7,0,4,2,16.4,0,2
204,8,0,21,3,19.1,3,0
204,9,0,0,4,22.3,3,1
204,10,0,5,2,18.1,2,0
204,11,0,15,1,21.6,0,1
204,12,0,11,3,23.3,3,0
204,13,0,15,4,17.5,2,2
204,14,0,0,1,20.1,0,1
204,15,0,2,4,18.0,1,3
204,16,0,0,2,23.3,1,1
204,17,0,0,6,22.0,3,3
204,18,0,18,5,21.1,2,3
204,19,0,4,2,17.9,1,1
204,20,0,0,3,19.2,0,3
204,21,0,4,2,20.1,1,1
204,22,0,0,7,24.0,3,4
204,23,0,28,8,20.5,4,4
204,24,0,33,5,22.8,4,1
204,25,0,23,5,21.9,3,2
204,26,0,35,6,19.4,1,5
204,27,0,18,4,22.6,2,2
204,28,0,1,2,23.8,1,1
204,29,0,24,5,23.0,4,1
204,30,0,17,3,27.1,2,1
205,1,1,84,18,60.2,8,10
205,2,1,99,25,59.8,11,14
205,3,1,78,19,60.5,8,11
205,4,1,94,24,60.4,8,16
205,5,1,88,25,61.2,8,17
205,6,1,72,22,58.2,13,9
205,7,1,58,18,61.2,10,8
205,8,1,83,28,61.9,16,12
205,9,1,84,29,62.1,13,16
205,10,1,86,31,58.1,13,18
205,11,1,65,24,63.8,7,17
205,12,1,80,28,60.1,11,17
205,13,1,49,19,60.2,8,11
205,14,1,61,25,62.0,17,8
205,15,1,75,31,69.7,17,14
205,16,1,87,41,63.2,20,21
205,17,1,93,41,64.9,17,24
205,18,1,84,38,61.1,18,20
205,19,1,51,26,60.8,19,7
205,20,1,46,22,63.8,11,11
205,21,1,47,24,61.5,9,15
205,22,1,106,56,62.3,23,33
205,23,1,64,33,59.9,12,21
205,24,1,64,34,59.1,21,13
205,25,1,93,52,62.3,30,22
205,26,1,46,26,59.7,10,16
205,27,1,31,21,64.6,10,11
205,28,1,54,34,63.5,10,24
205,29,1,93,57,59.4,19,38
205,30,1,62,40,67.2,24,16
206,1,0,52,5,57.1,0,5
206,2,0,79,7,58.3,1,6
206,3,0,53,7,57.4,3,4
206,4,0,64,5,59.3,1,4
206,5,0,62,8,57.9,1,7
206,6,0,49,7,57.9,2,5
206,7,0,13,2,58.2,1,1
206,8,0,23,5,59.2,2,3
206,9,0,64,6,57.9,0,6
206,10,0,63,10,62.0,4,6
206,11,0,56,8,56.4,0,8
206,12,0,31,6,56.5,1,5
206,13,0,28,3,61.9,2,1
206,14,0,41,7,59.1,3,4
206,15,0,41,9,61.2,6,3
206,16,0,47,7,57.7,4,3
206,17,0,74,10,54.8,3,7
206,18,0,26,4,57.2,0,4
206,19,0,61,13,56.4,3,10
206,20,0,43,6,60.4,0,6
206,21,0,22,8,57.3,1,7
206,22,0,53,11,53.8,5,6
206,23,0,67,13,57.4,3,10
206,24,0,40,8,57.3,2,6
206,25,0,64,15,58.9,4,11
206,26,0,31,6,58.4,3,3
206,27,0,43,9,55.6,2,7
206,28,0,32,9,57.7,4,5
206,29,0,55,12,61.0,3,9
206,30,0,73,15,56.6,7,8
207,1,0,74,5,25.5,2,3
207,2,0,93,11,24.5,1,10
207,3,0,24,3,25.1,1,2
207,4,0,58,6,26.9,2,4
207,5,0,58,8,27.2,4,4
207,6,0,42,4,27.2,1,3
207,7,0,55,6,26.2,1,5
207,8,0,77,10,23.7,2,8
207,9,0,85,12,20.8,4,8
207,10,0,78,8,26.3,3,5
207,11,0,77,8,19.2,2,6
207,12,0,63,8,23.5,3,5
207,13,0,47,7,25.7,2,5
207,14,0,49,10,21.9,3,7
207,15,0,94,13,25.8,6,7
207,16,0,69,15,27.7,6,9
207,17,0,76,10,25.9,4,6
207,18,0,40,7,26.6,2,5
207,19,0,75,14,24.5,4,10
207,20,0,37,6,25.4,2,4
207,21,0,25,8,21.4,5,3
207,22,0,64,11,25.8,4,7
207,23,0,70,12,19.7,3,9
207,24,0,48,9,23.3,3,6
207,25,0,48,11,24.0,3,8
207,26,0,63,11,22.4,2,9
207,27,0,38,8,22.3,3,5
207,28,0,30,8,23.1,2,6
207,29,0,78,20,23.8,7,13
207,30,0,78,18,26.6,8,10
208,1,1,19,7,75.5,4,3
208,2,1,47,15,78.3,5,10
208,3,1,0,5,77.3,2,3
208,4,1,23,6,80.4,2,4
208,5,1,24,6,84.4,5,1
208,6,1,7,2,80.7,1,1
208,7,1,34,12,78.6,7,5
208,8,1,26,8,76.9,2,6
208,9,1,5,2,79.3,0,2
208,10,1,6,5,82.5,4,1
208,11,1,47,17,81.8,6,11
208,12,1,48,18,78.5,4,14
208,13,1,0,3,79.3,1,2
208,14,1,0,1,81.7,1,0
208,15,1,31,14,90.7,9,5
208,16,1,0,0,81.5,0,0
208,17,1,33,17,81.3,15,2
208,18,1,13,6,79.9,3,3
208,19,1,0,2,81.5,0,2
208,20,1,3,1,80.7,1,0
208,21,1,27,13,81.1,5,8
208,22,1,0,1,80.6,0,1
208,23,1,50,28,80.5,13,15
208,24,1,36,21,82.9,14,7
208,25,1,25,15,82.3,6,9
208,26,1,9,5,80.2,2,3
208,27,1,16,11,79.6,6,5
208,28,1,35,23,80.4,13,10
208,29,1,11,7,79.7,4,3
208,30,1,5,3,78.9,1,2
209,1,0,100,8,44.9,4,4
209,2,0,88,9,50.1,5,4
209,3,0,104,11,49.7,9,2
209,4,0,87,8,44.5,5,3
209,5,0,128,13,48.4,7,6
209,6,0,52,4,46.0,3,1
209,7,0,71,7,51.6,7,0
209,8,0,123,12,52.3,5,7
209,9,0,90,10,42.0,6,4
209,10,0,112,13,49.4,9,4
209,11,0,106,15,46.6,10,5
209,12,0,113,13,47.1,8,5
209,13,0,76,11,50.1,8,3
209,14,0,58,10,50.5,7,3
209,15,0,110,17,45.8,12,5
209,16,0,99,15,47.9,11,4
209,17,0,104,18,48.9,12,6
209,18,0,106,17,47.5,6,11
209,19,0,112,21,51.5,14,7
209,20,0,66,13,46.5,6,7
209,21,0,78,14,47.5,7,7
209,22,0,103,18,50.7,13,5
209,23,0,120,26,49.2,18,8
209,24,0,103,20,46.9,14,6
209,25,0,105,19,47.8,14,5
209,26,0,97,17,50.5,13,4
209,27,0,94,19,49.2,11,8
209,28,0,71,16,49.3,11,5
209,29,0,121,24,50.8,17,7
209,30,0,93,21,49.9,13,8
210,1,1,8,3,77.5,0,3
210,2,1,33,8,73.9,3,5
210,3,1,7,5,76.6,3,2
210,4,1,48,14,75.9,9,5
210,5,1,33,8,74.4,3,5
210,6,1,30,11,75.0,7,4
210,7,1,7,4,73.2,1,3
210,8,1,3,2,74.8,2,0
210,9,1,0,5,74.8,3,2
210,10,1,8,6,75.2,3,3
210,11,1,15,6,75.4,5,1
210,12,1,0,1,76.7,0,1
210,13,1,9,3,76.6,2,1
210,14,1,1,2,76.6,1,1
210,15,1,0,3,80.7,1,2
210,16,1,33,15,73.4,5,10
210,17,1,15,7,73.3,4,3
210,18,1,3,2,76.5,1,1
210,19,1,33,14,76.5,11,3
210,20,1,8,5,78.7,3,2
210,21,1,13,7,74.3,4,3
210,22,1,18,11,75.7,5,6
210,23,1,12,6,79.7,4,2
210,24,1,5,5,76.7,3,2
210,25,1,4,3,73.7,1,2
210,26,1,14,9,76.2,2,7
210,27,1,14,8,74.1,4,4
210,28,1,3,2,74.5,1,1
210,29,1,4,2,73.7,1,1
210,30,1,16,10,75.3,6,4
211,1,1,89,20,70.2,14,6
211,2,1,68,17,65.9,10,7
211,3,1,74,18,66.2,7,11
211,4,1,92,24,69.4,12,12
211,5,1,80,24,68.3,13,11
211,6,1,45,15,71.9,9,6
211,7,1,36,12,68.7,8,4
211,8,1,86,29,67.2,13,16
211,9,1,77,25,69.5,15,10
211,10,1,87,33,68.0,17,16
211,11,1,67,24,65.3,9,15
211,12,1,71,27,69.9,20,7
211,13,1,39,15,66.1,7,8
211,14,1,43,18,67.9,7,11
211,15,1,79,33,62.7,13,20
211,16,1,47,22,67.6,7,15
211,17,1,62,27,63.9,16,11
211,18,1,79,35,66.6,14,21
211,19,1,60,28,66.8,20,8
211,20,1,46,22,69.0,8,14
211,21,1,41,21,69.6,10,11
211,22,1,82,40,63.7,16,24
211,23,1,93,50,70.1,22,28
211,24,1,96,52,66.4,30,22
211,25,1,97,51,65.5,25,26
211,26,1,67,37,71.2,22,15
211,27,1,52,29,66.8,15,14
211,28,1,65,39,63.8,18,21
211,29,1,77,45,69.1,27,18
211,30,1,83,49,66.4,19,30
212,1,1,45,9,57.3,3,6
212,2,1,63,16,56.7,8,8
212,3,1,66,15,53.7,8,7
212,4,1,57,16,54.5,10,6
212,5,1,58,18,54.9,10,8
212,6,1,42,12,53.1,7,5
212,7,1,36,12,56.4,5,7
212,8,1,60,20,58.3,9,11
212,9,1,50,18,52.5,7,11
212,10,1,92,32,56.4,12,20
212,11,1,60,22,50.6,5,17
212,12,1,71,26,55.0,15,11
212,13,1,38,15,54.8,7,8
212,14,1,51,20,54.0,9,11
212,15,1,74,29,52.6,15,14
212,16,1,61,28,57.4,14,14
212,17,1,62,26,55.9,15,11
212,18,1,65,29,56.1,14,15
212,19,1,62,31,58.3,20,11
212,20,1,41,19,57.7,8,11
212,21,1,42,22,53.8,12,10
212,22,1,60,31,54.9,18,13
212,23,1,63,34,56.8,19,15
212,24,1,58,31,55.8,14,17
212,25,1,44,25,57.4,14,11
212,26,1,90,51,57.6,30,21
212,27,1,38,21,59.4,17,4
212,28,1,29,20,59.0,10,10
212,29,1,52,32,55.9,12,20
212,30,1,66,40,55.8,22,18
213,1,0,1,3,59.3,2,1
213,2,0,11,4,59.1,1,3
213,3,0,18,2,57.9,0,2
213,4,0,53,4,57.3,1,3
213,5,0,19,1,56.7,0,1
213,6,0,0,1,59.6,0,1
213,7,0,8,5,57.1,3,2
213,8,0,23,5,56.8,2,3
213,9,0,21,2,55.8,0,2
213,10,0,30,6,58.2,2,4
213,11,0,25,2,61.0,0,2
213,12,0,15,3,55.2,1,2
213,13,0,14,1,56.9,1,0
213,14,0,24,6,58.6,1,5
213,15,0,26,4,59.2,2,2
213,16,0,0,1,59.6,0,1
213,17,0,24,4,56.1,3,1
213,18,0,15,4,56.6,1,3
213,19,0,16,2,54.3,1,1
213,20,0,18,4,52.1,0,4
213,21,0,12,2,58.8,0,2
213,22,0,0,1,55.2,0,1
213,23,0,9,3,55.5,0,3
213,24,0,43,9,58.0,5,4
213,25,0,36,7,54.8,3,4
213,26,0,38,10,57.3,4,6
213,27,0,34,6,57.7,3,3
213,28,0,16,4,57.5,0,4
213,29,0,43,9,58.8,4,5
213,30,0,8,3,56.9,0,3
214,1,0,98,8,26.7,6,2
214,2,0,136,12,30.2,6,6
214,3,0,133,11,29.8,9,2
214,4,0,130,12,26.1,6,6
214,5,0,125,11,27.2,5,6
214,6,0,61,6,26.0,5,1
214,7,0,76,7,24.8,5,2
214,8,0,104,12,26.9,4,8
214,9,0,129,15,28.7,8,7
214,10,0,116,13,28.5,10,3
214,11,0,127,15,27.6,13,2
214,12,0,115,15,22.6,13,2
214,13,0,70,11,27.2,6,5
214,14,0,75,11,24.4,4,7
214,15,0,118,19,32.7,16,3
214,16,0,105,14,27.7,9,5
214,17,0,102,16,25.3,11,5
214,18,0,99,14,29.8,9,5
214,19,0,122,23,24.8,13,10
214,20,0,79,12,22.9,8,4
214,21,0,61,10,27.2,8,2
214,22,0,94,17,25.4,10,7
214,23,0,121,21,24.4,14,7
214,24,0,126,25,23.5,21,4
214,25,0,122,22,29.0,16,6
214,26,0,81,15,27.3,10,5
214,27,0,70,16,27.7,12,4
214,28,0,66,12,28.6,9,3
214,29,0,115,25,27.8,17,8
214,30,0,94,18,24.5,9,9
215,1,1,38,14,79.1,9,5
215,2,1,6,2,81.9,2,0
215,3,1,23,8,78.0,6,2
215,4,1,0,2,82.9,2,0
215,5,1,34,12,79.4,3,9
215,6,1,20,7,77.7,2,5
215,7,1,24,8,78.3,2,6
215,8,1,23,8,77.3,3,5
215,9,1,0,0,78.4,0,0
215,10,1,32,13,80.9,4,9
215,11,1,26,12,75.0,5,7
215,12,1,13,7,82.2,3,4
215,13,1,20,11,80.0,5,6
215,14,1,5,4,81.7,1,3
215,15,1,31,15,76.7,6,9
215,16,1,0,3,80.2,0,3
215,17,1,47,20,76.9,6,14
215,18,1,12,6,80.3,3,3
215,19,1,0,4,80.0,3,1
215,20,1,14,9,78.4,5,4
215,21,1,0,3,80.7,2,1
215,22,1,30,17,77.0,6,11
215,23,1,0,1,81.7,1,0
215,24,1,31,17,79.7,5,12
215,25,1,4,4,79.9,2,2
215,26,1,1,3,75.1,2,1
215,27,1,1,1,76.0,0,1
215,28,1,19,10,80.8,5,5
215,29,1,17,12,79.6,8,4
215,30,1,1,1,83.3,0,1
216,1,0,73,9,33.7,5,4
216,2,0,82,9,29.9,6,3
216,3,0,48,4,31.1,3,1
216,4,0,81,9,31.4,4,5
216,5,0,49,7,29.1,5,2
216,6,0,38,5,33.8,2,3
216,7,0,34,5,31.7,2,3
216,8,0,39,6,33.1,3,3
216,9,0,61,10,34.8,5,5
216,10,0,24,7,32.1,4,3
216,11,0,33,4,30.9,3,1
216,12,0,51,10,33.1,5,5
216,13,0,66,11,32.9,9,2
216,14,0,39,8,29.3,4,4
216,15,0,51,9,35.1,4,5
216,16,0,62,8,29.9,5,3
216,17,0,25,5,28.5,3,2
216,18,0,44,10,30.5,4,6
216,19,0,50,8,31.6,3,5
216,20,0,32,7,29.3,5,2
216,21,0,45,11,32.4,7,4
216,22,0,66,14,32.7,5,9
216,23,0,54,10,33.1,2,8
216,24,0,57,9,30.7,2,7
216,25,0,68,12,31.4,6,6
216,26,0,44,11,30.4,4,7
216,27,0,36,8,36.1,4,4
216,28,0,50,14,29.6,9,5
216,29,0,76,14,33.4,8,6
216,30,0,81,18,30.2,10,8
217,1,0,58,10,52.6,7,3
217,2,0,51,6,50.3,3,3
217,3,0,57,7,53.1,5,2
217,4,0,20,4,54.6,2,2
217,5,0,49,6,51.7,4,2
217,6,0,44,7,52.0,4,3
217,7,0,5,5,53.6,3,2
217,8,0,71,11,54.5,8,3
217,9,0,50,6,54.1,3,3
217,10,0,21,6,58.5,5,1
217,11,0,29,3,55.0,2,1
217,12,0,78,10,52.5,6,4
217,13,0,41,7,53.2,4,3
217,14,0,30,7,48.5,5,2
217,15,0,47,7,52.8,5,2
217,16,0,78,10,52.2,6,4
217,17,0,42,6,53.7,5,1
217,18,0,30,6,51.9,4,2
217,19,0,52,9,54.1,5,4
217,20,0,21,4,51.0,0,4
217,21,0,56,9,49.5,6,3
217,22,0,67,15,55.6,11,4
217,23,0,74,13,53.8,6,7
217,24,0,49,9,54.5,7,2
217,25,0,30,6,52.2,5,1
217,26,0,50,9,56.2,6,3
217,27,0,37,8,53.2,7,1
217,28,0,25,5,52.4,4,1
217,29,0,22,5,53.5,2,3
217,30,0,56,12,54.6,7,5
218,1,1,53,13,19.2,3,10
218,2,1,76,21,24.0,10,11
218,3,1,46,12,19.7,5,7
218,4,1,78,22,18.3,11,11
218,5,1,58,15,22.8,10,5
218,6,1,48,13,20.3,5,8
218,7,1,51,16,20.6,8,8
218,8,1,71,22,22.6,11,11
218,9,1,27,10,19.4,9,1
218,10,1,46,18,24.2,7,11
218,11,1,48,19,21.4,10,9
218,12,1,50,18,20.6,14,4
218,13,1,60,24,21.9,10,14
218,14,1,50,23,19.2,17,6
218,15,1,71,31,27.2,11,20
218,16,1,61,25,22.7,12,13
218,17,1,62,28,21.2,14,14
218,18,1,63,29,24.6,15,14
218,19,1,63,30,22.5,20,10
218,20,1,52,28,23.0,15,13
218,21,1,56,29,20.8,15,14
218,22,1,55,29,22.0,15,14
218,23,1,76,38,19.8,18,20
218,24,1,73,39,22.3,13,26
218,25,1,82,43,23.1,25,18
218,26,1,90,53,18.8,28,25
218,27,1,58,37,17.9,25,12
218,28,1,46,26,20.8,12,14
218,29,1,64,40,23.3,22,18
218,30,1,96,60,24.7,36,24
219,1,0,67,7,27.3,4,3
219,2,0,57,6,29.3,4,2
219,3,0,42,3,26.3,2,1
219,4,0,71,5,25.7,1,4
219,5,0,70,10,27.3,6,4
219,6,0,53,6,22.9,2,4
219,7,0,55,6,27.2,4,2
219,8,0,61,7,27.9,4,3
219,9,0,48,6,24.1,2,4
219,10,0,47,6,25.6,5,1
219,11,0,62,11,28.5,8,3
219,12,0,85,12,27.5,4,8
219,13,0,59,10,26.6,2,8
219,14,0,39,7,29.5,5,2
219,15,0,65,10,13.6,5,5
219,16,0,59,8,26.7,4,4
219,17,0,69,13,23.0,6,7
219,18,0,73,14,26.8,9,5
219,19,0,67,12,28.8,9,3
219,20,0,46,9,23.6,5,4
219,21,0,72,14,28.0,7,7
219,22,0,62,11,24.1,6,5
219,23,0,69,14,26.9,5,9
219,24,0,57,11,27.3,8,3
219,25,0,74,13,24.5,7,6
219,26,0,90,16,27.8,6,10
219,27,0,49,10,24.5,6,4
219,28,0,46,10,23.6,6,4
219,29,0,52,13,30.6,9,4
219,30,0,46,10,25.6,6,4
220,1,0,25,4,32.3,2,2
220,2,0,42,6,29.7,4,2
220,3,0,28,6,32.4,5,1
220,4,0,48,5,33.1,5,0
220,5,0,38,4,34.4,4,0
220,6,0,15,6,35.2,5,1
220,7,0,31,4,31.2,2,2
220,8,0,32,5,32.5,4,1
220,9,0,16,5,33.1,3,2
220,10,0,31,5,33.0,2,3
220,11,0,48,5,35.2,4,1
220,12,0,54,8,32.7,7,1
220,13,0,31,5,30.4,0,5
220,14,0,18,5,34.5,5,0
220,15,0,13,2,30.5,1,1
220,16,0,15,3,31.5,1,2
220,17,0,33,6,32.1,5,1
220,18,0,56,9,32.0,5,4
220,19,0,33,6,29.9,3,3
220,20,0,37,6,29.2,5,1
220,21,0,26,6,30.9,6,0
220,22,0,22,4,32.8,2,2
220,23,0,27,8,30.3,4,4
220,24,0,3,2,32.5,2,0
220,25,0,32,6,31.1,3,3
220,26,0,28,5,31.5,3,2
220,27,0,33,8,29.8,3,5
220,28,0,27,9,37.4,6,3
220,29,0,28,6,34.2,5,1
220,30,0,25,6,28.4,3,3
221,1,0,76,7,36.7,2,5
221,2,0,95,9,37.0,2,7
221,3,0,102,9,38.3,2,7
221,4,0,105,9,38.1,3,6
221,5,0,87,10,38.4,5,5
221,6,0,89,12,34.2,4,8
221,7,0,88,10,38.8,2,8
221,8,0,115,12,36.6,4,8
221,9,0,117,13,33.4,4,9
221,10,0,111,14,39.7,3,11
221,11,0,98,14,38.0,6,8
221,12,0,104,15,36.7,7,8
221,13,0,72,9,41.3,5,4
221,14,0,78,13,36.2,6,7
221,15,0,81,16,35.5,10,6
221,16,0,118,20,36.0,7,13
221,17,0,84,13,37.7,5,8
221,18,0,108,16,33.7,3,13
221,19,0,131,20,35.9,6,14
221,20,0,67,12,42.5,2,10
221,21,0,71,11,37.6,5,6
221,22,0,101,19,39.6,9,10
221,23,0,121,21,36.5,6,15
221,24,0,91,16,38.7,5,11
221,25,0,108,22,35.9,7,15
221,26,0,122,23,36.2,7,16
221,27,0,80,15,37.2,5,10
221,28,0,73,13,38.6,5,8
221,29,0,93,20,38.3,7,13
221,30,0,114,27,36.2,10,17
222,1,1,40,10,38.5,5,5
222,2,1,21,9,37.4,6,3
222,3,1,3,1,42.2,1,0
222,4,1,0,3,39.0,2,1
222,5,1,42,14,39.2,8,6
222,6,1,13,7,38.7,4,3
222,7,1,31,9,43.6,5,4
222,8,1,30,13,40.0,10,3
222,9,1,19,7,39.3,4,3
222,10,1,23,9,39.4,4,5
222,11,1,17,7,41.2,3,4
222,12,1,18,8,33.5,4,4
222,13,1,17,7,39.4,3,4
222,14,1,24,10,38.3,5,5
222,15,1,0,2,49.6,0,2
222,16,1,24,13,37.4,10,3
222,17,1,53,22,36.9,10,12
222,18,1,35,15,36.5,8,7
222,19,1,32,16,35.8,9,7
222,20,1,20,12,39.8,5,7
222,21,1,29,16,37.1,5,11
222,22,1,25,14,39.6,9,5
222,23,1,19,9,37.5,7,2
222,24,1,56,33,36.1,14,19
222,25,1,29,17,38.6,7,10
222,26,1,45,27,36.1,12,15
222,27,1,40,28,35.3,11,17
222,28,1,9,6,37.1,2,4
222,29,1,19,12,34.8,5,7
222,30,1,38,27,38.1,18,9
223,1,0,0,3,22.6,3,0
223,2,0,19,2,25.8,2,0
223,3,0,5,2,22.0,1,1
223,4,0,44,3,24.7,1,2
223,5,0,23,4,22.3,3,1
223,6,0,20,2,25.8,1,1
223,7,0,21,4,21.5,2,2
223,8,0,27,6,23.1,3,3
223,9,0,24,6,22.4,4,2
223,10,0,25,5,17.6,0,5
223,11,0,38,5,20.3,4,1
223,12,0,16,2,24.2,2,0
223,13,0,20,4,22.4,2,2
223,14,0,16,3,24.2,2,1
223,15,0,26,4,31.3,1,3
223,16,0,42,5,26.3,3,2
223,17,0,14,1,22.5,1,0
223,18,0,0,3,21.2,3,0
223,19,0,46,8,25.4,7,1
223,20,0,12,2,24.3,0,2
223,21,0,12,4,22.6,2,2
223,22,0,25,8,24.9,2,6
223,23,0,11,3,26.5,0,3
223,24,0,23,7,22.7,4,3
223,25,0,21,6,22.0,4,2
223,26,0,14,5,26.2,3,2
223,27,0,18,8,22.5,5,3
223,28,0,3,2,21.9,2,0
223,29,0,13,5,23.9,3,2
223,30,0,15,6,22.7,2,4
224,1,0,53,8,21.2,4,4
224,2,0,20,1,21.6,0,1
224,3,0,22,4,26.3,0,4
224,4,0,23,5,25.8,1,4
224,5,0,15,2,21.5,2,0
224,6,0,2,2,21.7,0,2
224,7,0,16,4,25.2,2,2
224,8,0,38,4,19.1,3,1
224,9,0,30,4,20.1,1,3
224,10,0,49,8,18.6,5,3
224,11,0,26,5,24.8,2,3
224,12,0,28,4,20.9,1,3
224,13,0,34,7,22.2,4,3
224,14,0,33,5,20.6,3,2
224,15,0,42,6,17.2,4,2
224,16,0,33,6,20.8,2,4
224,17,0,26,8,19.1,4,4
224,18,0,24,6,21.2,3,3
224,19,0,18,8,20.1,4,4
224,20,0,23,6,21.0,3,3
224,21,0,25,4,19.5,0,4
224,22,0,57,10,22.6,4,6
224,23,0,32,8,22.1,3,5
224,24,0,55,13,24.0,5,8
224,25,0,39,10,23.7,3,7
224,26,0,61,13,23.9,5,8
224,27,0,32,5,22.6,3,2
224,28,0,29,7,22.7,5,2
224,29,0,21,9,20.1,3,6
224,30,0,29,8,22.8,6,2
225,1,0,45,5,24.5,0,5
225,2,0,59,9,26.8,2,7
225,3,0,75,8,20.4,3,5
225,4,0,68,7,26.5,1,6
225,5,0,58,6,24.6,1,5
225,6,0,38,6,22.7,3,3
225,7,0,47,6,25.3,3,3
225,8,0,56,10,22.6,5,5
225,9,0,64,6,23.3,0,6
225,10,0,90,11,22.4,3,8
225,11,0,45,7,27.0,2,5
225,12,0,65,9,24.5,4,5
225,13,0,36,5,25.2,0,5
225,14,0,33,7,27.6,2,5
225,15,0,76,12,26.4,4,8
225,16,0,54,11,21.8,1,10
225,17,0,80,14,25.6,3,11
225,18,0,57,9,24.9,6,3
225,19,0,82,13,25.5,3,10
225,20,0,61,11,23.9,5,6
225,21,0,34,7,27.7,5,2
225,22,0,65,11,24.1,1,10
225,23,0,61,10,25.0,7,3
225,24,0,38,8,24.6,3,5
225,25,0,67,13,24.1,3,10
225,26,0,66,14,24.1,3,11
225,27,0,52,10,22.4,2,8
225,28,0,38,8,22.9,6,2
225,29,0,75,15,21.1,4,11
225,30,0,85,21,24.8,12,9
226,1,0,108,9,63.0,6,3
226,2,0,102,9,63.0,2,7
226,3,0,91,8,64.4,3,5
226,4,0,104,9,67.9,4,5
226,5,0,115,13,66.3,6,7
226,6,0,95,10,66.7,2,8
226,7,0,51,6,67.1,2,4
226,8,0,114,12,63.5,4,8
226,9,0,107,12,67.3,7,5
226,10,0,76,8,64.4,4,4
226,11,0,98,14,63.9,6,8
226,12,0,99,11,63.7,2,9
226,13,0,95,12,64.8,5,7
226,14,0,71,11,64.9,4,7
226,15,0,137,19,66.4,4,15
226,16,0,122,19,64.6,10,9
226,17,0,114,20,63.3,8,12
226,18,0,90,17,65.8,9,8
226,19,0,116,20,67.8,5,15
226,20,0,83,14,68.3,1,13
226,21,0,89,17,64.7,4,13
226,22,0,96,16,66.5,6,10
226,23,0,117,19,68.0,6,13
226,24,0,130,23,63.7,9,14
226,25,0,109,21,62.8,7,14
226,26,0,95,18,66.1,7,11
226,27,0,72,15,64.5,7,8
226,28,0,77,15,61.8,6,9
226,29,0,110,23,69.3,8,15
226,30,0,124,27,63.9,11,16
227,1,0,50,4,62.5,2,2
227,2,0,66,8,64.3,3,5
227,3,0,47,8,62.5,2,6
227,4,0,50,8,62.5,2,6
227,5,0,30,4,61.5,2,2
227,6,0,36,3,64.7,0,3
227,7,0,29,3,60.5,1,2
227,8,0,57,5,67.7,1,4
227,9,0,47,10,67.1,1,9
227,10,0,51,5,67.1,2,3
227,11,0,45,6,62.3,1,5
227,12,0,41,5,62.9,1,4
227,13,0,45,10,63.6,4,6
227,14,0,52,7,59.3,2,5
227,15,0,41,7,67.9,3,4
227,16,0,42,7,63.5,3,4
227,17,0,46,10,64.7,4,6
227,18,0,55,10,61.6,7,3
227,19,0,61,10,66.3,5,5
227,20,0,39,8,67.7,3,5
227,21,0,28,6,64.5,2,4
227,22,0,60,12,65.2,6,6
227,23,0,42,10,63.2,5,5
227,24,0,60,16,63.0,5,11
227,25,0,66,15,64.5,6,9
227,26,0,58,12,65.2,4,8
227,27,0,38,11,63.1,3,8
227,28,0,43,10,62.8,3,7
227,29,0,64,15,63.7,5,10
227,30,0,64,12,62.8,6,6
228,1,0,54,4,62.4,2,2
228,2,0,57,6,62.1,1,5
228,3,0,51,5,62.7,2,3
228,4,0,60,7,62.5,2,5
228,5,0,77,7,62.2,3,4
228,6,0,32,5,67.2,1,4
228,7,0,39,3,63.2,1,2
228,8,0,63,6,63.7,1,5
228,9,0,80,12,65.9,4,8
228,10,0,99,10,67.9,5,5
228,11,0,83,9,58.5,5,4
228,12,0,82,14,63.4,3,11
228,13,0,39,5,68.2,2,3
228,14,0,50,7,67.1,3,4
228,15,0,62,10,69.3,3,7
228,16,0,89,14,64.7,7,7
228,17,0,68,10,63.4,3,7
228,18,0,53,7,64.3,6,1
228,19,0,54,12,61.5,5,7
228,20,0,49,11,63.3,4,7
228,21,0,42,7,65.4,2,5
228,22,0,70,12,68.0,4,8
228,23,0,72,13,65.1,6,7
228,24,0,67,12,66.2,8,4
228,25,0,86,16,62.1,9,7
228,26,0,71,15,66.0,7,8
228,27,0,50,10,64.3,2,8
228,28,0,38,13,63.1,5,8
228,29,0,66,15,63.5,3,12
228,30,0,77,16,65.6,4,12
229,1,0,15,3,32.4,1,2
229,2,0,40,4,32.4,2,2
229,3,0,38,5,32.4,1,4
229,4,0,0,1,33.5,0,1
229,5,0,30,2,33.1,2,0
229,6,0,17,1,29.2,1,0
229,7,0,11,3,32.6,2,1
229,8,0,27,3,35.0,2,1
229,9,0,29,6,30.4,4,2
229,10,0,50,9,27.9,6,3
229,11,0,50,9,33.5,5,4
229,12,0,31,4,31.3,0,4
229,13,0,35,7,33.1,4,3
229,14,0,14,2,29.2,1,1
229,15,0,20,3,25.1,1,2
229,16,0,14,2,33.0,0,2
229,17,0,35,7,30.7,5,2
229,18,0,20,2,30.1,1,1
229,19,0,40,8,32.4,4,4
229,20,0,18,4,33.7,2,2
229,21,0,10,3,31.1,1,2
229,22,0,8,1,29.4,1,0
229,23,0,14,3,31.1,2,1
229,24,0,42,7,30.5,3,4
229,25,0,0,1,29.6,0,1
229,26,0,14,3,36.0,2,1
229,27,0,13,3,32.1,2,1
229,28,0,13,3,33.3,1,2
229,29,0,25,5,28.4,5,0
229,30,0,27,7,32.9,3,4
230,1,1,37,7,22.6,2,5
230,2,1,26,9,20.1,3,6
230,3,1,47,11,24.8,5,6
230,4,1,52,17,22.7,9,8
230,5,1,32,10,20.3,8,2
230,6,1,34,10,24.0,5,5
230,7,1,25,7,25.3,3,4
230,8,1,48,16,23.4,9,7
230,9,1,39,15,21.1,1,14
230,10,1,47,16,18.6,6,10
230,11,1,20,8,22.6,3,5
230,12,1,42,18,24.7,7,11
230,13,1,22,10,25.6,4,6
230,14,1,25,13,26.1,10,3
230,15,1,51,23,17.9,15,8
230,16,1,54,26,24.0,16,10
230,17,1,63,27,22.3,10,17
230,18,1,40,22,24.5,12,10
230,19,1,56,25,20.5,11,14
230,20,1,19,9,24.6,6,3
230,21,1,37,18,20.5,9,9
230,22,1,65,34,23.0,14,20
230,23,1,26,14,24.4,9,5
230,24,1,46,27,23.3,17,10
230,25,1,49,31,24.3,14,17
230,26,1,32,20,22.5,15,5
230,27,1,11,9,21.3,5,4
230,28,1,24,13,23.2,8,5
230,29,1,60,35,21.7,22,13
230,30,1,11,8,24.5,5,3
231,1,0,24,5,68.5,3,2
231,2,0,13,5,64.9,3,2
231,3,0,14,6,63.6,3,3
231,4,0,18,3,68.2,0,3
231,5,0,32,6,65.4,3,3
231,6,0,8,3,68.6,2,1
231,7,0,21,5,66.3,4,1
231,8,0,20,6,68.4,2,4
231,9,0,35,4,68.3,2,2
231,10,0,7,1,68.1,1,0
231,11,0,32,4,67.8,0,4
231,12,0,18,3,68.0,1,2
231,13,0,42,6,67.2,3,3
231,14,0,11,1,66.9,1,0
231,15,0,23,5,64.7,3,2
231,16,0,29,5,69.7,3,2
231,17,0,29,5,64.5,1,4
231,18,0,48,7,67.3,2,5
231,19,0,1,2,67.1,0,2
231,20,0,20,9,68.1,3,6
231,21,0,16,2,68.2,1,1
231,22,0,25,6,63.8,1,5
231,23,0,34,8,68.4,2,6
231,24,0,38,9,67.5,6,3
231,25,0,28,7,70.3,2,5
231,26,0,43,10,64.2,2,8
231,27,0,18,4,67.4,1,3
231,28,0,31,8,67.0,4,4
231,29,0,24,6,68.7,2,4
231,30,0,14,5,67.8,3,2
232,1,0,82,10,79.8,2,8
232,2,0,43,7,76.8,2,5
232,3,0,47,5,77.8,3,2
232,4,0,59,6,77.7,1,5
232,5,0,83,8,80.0,2,6
232,6,0,46,4,79.7,3,1
232,7,0,41,5,80.7,1,4
232,8,0,72,7,81.7,4,3
232,9,0,110,12,82.0,4,8
232,10,0,75,9,84.3,6,3
232,11,0,93,13,80.0,7,6
232,12,0,88,11,82.2,2,9
232,13,0,47,6,76.2,3,3
232,14,0,56,11,78.2,6,5
232,15,0,69,11,81.8,3,8
232,16,0,83,15,83.3,8,7
232,17,0,59,12,79.7,4,8
232,18,0,59,9,77.3,1,8
232,19,0,80,14,80.3,5,9
232,20,0,60,12,80.6,3,9
232,21,0,58,9,83.8,3,6
232,22,0,60,12,78.5,5,7
232,23,0,65,14,78.3,5,9
232,24,0,79,16,81.4,6,10
232,25,0,51,13,79.7,5,8
232,26,0,62,13,79.9,5,8
232,27,0,55,10,76.7,3,7
232,28,0,57,14,80.0,4,10
232,29,0,49,13,76.8,4,9
232,30,0,71,15,78.0,9,6
233,1,0,17,3,31.6,2,1
233,2,0,31,5,36.6,3,2
233,3,0,22,2,34.0,1,1
233,4,0,12,3,35.9,2,1
233,5,0,24,2,37.6,2,0
233,6,0,0,0,35.1,0,0
233,7,0,7,1,35.7,0,1
233,8,0,14,6,37.7,4,2
233,9,0,44,6,36.0,5,1
233,10,0,6,1,38.3,1,0
233,11,0,33,3,38.3,3,0
233,12,0,0,2,38.7,1,1
233,13,0,2,3,35.0,2,1
233,14,0,15,3,34.8,2,1
233,15,0,13,4,42.7,2,2
233,16,0,0,2,35.0,1,1
233,17,0,26,3,37.5,1,2
233,18,0,21,5,33.0,3,2
233,19,0,14,3,39.0,1,2
233,20,0,0,0,35.8,0,0
233,21,0,25,7,36.9,5,2
233,22,0,28,6,37.1,3,3
233,23,0,23,7,35.2,6,1
233,24,0,39,8,34.6,6,2
233,25,0,1,1,33.6,1,0
233,26,0,27,8,33.2,5,3
233,27,0,9,2,35.6,0,2
233,28,0,8,3,33.9,2,1
233,29,0,21,6,34.9,4,2
233,30,0,11,6,35.2,2,4
234,1,1,75,20,24.0,9,11
234,2,1,96,23,28.4,12,11
234,3,1,66,18,24.8,5,13
234,4,1,107,27,24.5,11,16
234,5,1,59,15,22.8,10,5
234,6,1,50,14,25.2,5,9
234,7,1,63,21,25.7,13,8
234,8,1,82,27,22.9,16,11
234,9,1,94,32,24.1,17,15
234,10,1,84,31,22.3,14,17
234,11,1,82,30,28.0,17,13
234,12,1,70,30,28.2,13,17
234,13,1,59,23,24.9,13,10
234,14,1,49,21,25.4,7,14
234,15,1,80,34,25.2,17,17
234,16,1,100,41,25.9,23,18
234,17,1,99,46,24.6,27,19
234,18,1,93,41,23.2,24,17
234,19,1,77,34,28.0,17,17
234,20,1,62,33,23.7,15,18
234,21,1,58,29,24.1,18,11
234,22,1,66,38,27.6,19,19
234,23,1,72,39,26.5,23,16
234,24,1,83,48,29.2,27,21
234,25,1,97,52,23.3,28,24
234,26,1,50,28,27.8,20,8
234,27,1,65,39,27.5,25,14
234,28,1,47,27,27.2,16,11
234,29,1,65,41,27.0,24,17
234,30,1,94,58,27.5,35,23
235,1,0,33,3,72.0,3,0
235,2,0,57,5,73.6,3,2
235,3,0,62,5,72.6,5,0
235,4,0,25,4,74.1,4,0
235,5,0,69,8,74.4,5,3
235,6,0,29,4,75.5,3,1
235,7,0,39,6,73.2,5,1
235,8,0,43,8,74.3,4,4
235,9,0,78,12,73.8,8,4
235,10,0,48,10,72.9,8,2
235,11,0,56,8,74.8,5,3
235,12,0,45,10,75.5,6,4
235,13,0,46,10,72.9,6,4
235,14,0,39,6,76.5,4,2
235,15,0,57,11,73.7,9,2
235,16,0,26,5,70.4,2,3
235,17,0,63,13,74.8,8,5
235,18,0,35,7,74.3,3,4
235,19,0,34,10,76.7,9,1
235,20,0,52,10,76.2,5,5
235,21,0,29,7,69.7,6,1
235,22,0,45,10,71.7,6,4
235,23,0,17,4,73.5,3,1
235,24,0,59,12,73.8,5,7
235,25,0,26,7,74.5,5,2
235,26,0,29,8,71.3,6,2
235,27,0,33,10,74.1,6,4
235,28,0,47,11,75.4,6,5
235,29,0,58,15,74.2,11,4
235,30,0,44,10,73.7,5,5
236,1,0,18,4,43.0,3,1
236,2,0,26,2,38.0,2,0
236,3,0,33,4,43.7,1,3
236,4,0,40,6,40.8,2,4
236,5,0,16,4,40.7,4,0
236,6,0,13,3,41.3,1,2
236,7,0,15,3,39.1,2,1
236,8,0,24,5,44.5,1,4
236,9,0,39,7,42.5,6,1
236,10,0,44,7,43.5,4,3
236,11,0,43,10,43.1,2,8
236,12,0,11,2,43.4,1,1
236,13,0,0,2,41.9,2,0
236,14,0,8,4,41.1,3,1
236,15,0,0,2,43.3,1,1
236,16,0,0,1,40.2,0,1
236,17,0,28,5,43.9,4,1
236,18,0,27,5,41.2,2,3
236,19,0,68,12,40.2,7,5
236,20,0,33,8,42.0,5,3
236,21,0,29,6,37.9,2,4
236,22,0,18,4,44.2,2,2
236,23,0,46,9,42.8,9,0
236,24,0,35,12,40.4,8,4
236,25,0,24,6,45.2,1,5
236,26,0,48,8,42.9,5,3
236,27,0,36,6,42.9,1,5
236,28,0,0,4,40.9,1,3
236,29,0,59,13,41.8,5,8
236,30,0,30,8,42.2,6,2
237,1,1,91,20,57.7,13,7
237,2,1,109,24,55.6,14,10
237,3,1,118,34,54.5,16,18
237,4,1,113,31,55.8,14,17
237,5,1,79,24,52.7,11,13
237,6,1,99,30,55.7,15,15
237,7,1,71,20,52.4,9,11
237,8,1,109,34,52.9,17,17
237,9,1,114,36,55.5,17,19
237,10,1,119,40,53.1,27,13
237,11,1,140,52,56.0,25,27
237,12,1,114,42,52.7,13,29
237,13,1,60,23,54.8,10,13
237,14,1,65,26,59.5,19,7
237,15,1,120,49,46.5,30,19
237,16,1,117,50,57.2,30,20
237,17,1,145,64,55.7,31,33
237,18,1,90,41,52.9,15,26
237,19,1,106,50,53.5,24,26
237,20,1,71,37,55.4,16,21
237,21,1,71,35,53.6,15,20
237,22,1,118,60,54.1,31,29
237,23,1,88,45,54.0,22,23
237,24,1,133,71,57.2,37,34
237,25,1,108,61,53.1,35,26
237,26,1,124,70,53.5,34,36
237,27,1,74,43,58.6,25,18
237,28,1,73,41,55.4,27,14
237,29,1,98,59,54.2,28,31
237,30,1,124,76,56.3,36,40
238,1,0,43,6,28.7,1,5
238,2,0,72,7,30.8,3,4
238,3,0,18,2,31.5,1,1
238,4,0,55,6,31.0,5,1
238,5,0,49,7,34.6,2,5
238,6,0,15,3,32.1,0,3
238,7,0,48,6,30.0,4,2
238,8,0,50,6,33.4,3,3
238,9,0,39,6,31.8,5,1
238,10,0,18,3,31.5,1,2
238,11,0,14,3,32.2,1,2
238,12,0,27,4,30.7,2,2
238,13,0,25,4,32.1,4,0
238,14,0,19,3,31.4,2,1
238,15,0,46,7,31.0,4,3
238,16,0,40,10,30.7,6,4
238,17,0,26,4,33.2,2,2
238,18,0,24,4,29.0,2,2
238,19,0,54,8,31.7,4,4
238,20,0,35,7,30.2,3,4
238,21,0,33,7,30.0,2,5
238,22,0,27,6,30.3,4,2
238,23,0,18,5,30.0,2,3
238,24,0,37,11,32.9,7,4
238,25,0,36,6,30.1,3,3
238,26,0,53,9,30.7,6,3
238,27,0,20,4,32.7,2,2
238,28,0,29,6,29.3,5,1
238,29,0,43,11,35.1,4,7
238,30,0,21,6,34.8,2,4
239,1,1,89,22,69.8,10,12
239,2,1,63,16,69.1,6,10
239,3,1,81,22,69.3,8,14
239,4,1,73,19,72.7,10,9
239,5,1,70,22,69.8,10,12
239,6,1,56,19,67.0,7,12
239,7,1,58,19,67.9,9,10
239,8,1,91,29,70.2,15,14
239,9,1,84,29,70.1,20,9
239,10,1,91,30,68.9,15,15
239,11,1,101,36,71.6,20,16
239,12,1,71,28,70.7,11,17
239,13,1,54,20,68.3,11,9
239,14,1,51,20,71.8,9,11
239,15,1,114,49,71.9,26,23
239,16,1,53,23,68.3,10,13
239,17,1,83,38,71.9,18,20
239,18,1,61,32,71.3,17,15
239,19,1,78,35,65.2,11,24
239,20,1,55,27,67.8,7,20
239,21,1,64,33,71.7,26,7
239,22,1,78,39,71.4,23,16
239,23,1,94,48,73.1,28,20
239,24,1,82,45,68.4,18,27
239,25,1,56,31,71.8,12,19
239,26,1,87,48,69.1,22,26
239,27,1,64,36,69.4,15,21
239,28,1,77,47,65.9,21,26
239,29,1,108,64,71.2,39,25
239,30,1,100,62,71.3,28,34
240,1,0,92,8,29.2,2,6
240,2,0,73,7,26.7,2,5
240,3,0,82,7,26.4,3,4
240,4,0,70,9,30.0,4,5
240,5,0,75,9,28.8,5,4
240,6,0,62,12,27.9,5,7
240,7,0,63,9,28.9,1,8
240,8,0,75,9,25.3,3,6
240,9,0,93,11,27.5,3,8
240,10,0,54,7,28.7,5,2
240,11,0,94,12,25.5,6,6
240,12,0,75,10,26.7,6,4
240,13,0,71,8,26.2,4,4
240,14,0,66,9,27.6,4,5
240,15,0,80,15,20.1,7,8
240,16,0,103,17,31.1,7,10
240,17,0,94,15,29.3,8,7
240,18,0,79,11,27.6,10,1
240,19,0,77,14,29.7,9,5
240,20,0,70,10,27.8,4,6
240,21,0,58,10,30.3,7,3
240,22,0,70,12,26.3,5,7
240,23,0,99,17,27.2,7,10
240,24,0,96,19,31.1,7,12
240,25,0,93,18,26.9,10,8
240,26,0,101,21,32.7,8,13
240,27,0,54,12,28.7,6,6
240,28,0,51,10,25.8,2,8
240,29,0,99,22,27.8,14,8
240,30,0,95,22,28.8,11,11
241,1,0,17,2,69.4,1,1
241,2,0,4,0,73.0,0,0
241,3,0,15,3,74.0,1,2
241,4,0,47,7,71.6,1,6
241,5,0,46,7,73.8,0,7
241,6,0,34,4,74.9,0,4
241,7,0,13,2,68.8,0,2
241,8,0,28,3,72.0,1,2
241,9,0,0,2,73.5,0,2
241,10,0,13,2,70.1,0,2
241,11,0,2,1,72.7,1,0
241,12,0,26,5,73.2,1,4
241,13,0,8,2,72.1,1,1
241,14,0,14,1,76.3,0,1
241,15,0,31,6,66.8,3,3
241,16,0,0,1,76.9,0,1
241,17,0,15,3,71.6,2,1
241,18,0,10,3,73.3,1,2
241,19,0,21,4,70.1,1,3
241,20,0,7,2,74.7,1,1
241,21,0,12,4,71.3,2,2
241,22,0,20,5,73.3,0,5
241,23,0,17,4,74.4,2,2
241,24,0,14,4,73.0,0,4
241,25,0,0,2,76.6,0,2
241,26,0,20,6,76.1,3,3
241,27,0,1,3,75.5,1,2
241,28,0,0,1,75.1,0,1
241,29,0,0,2,70.5,0,2
241,30,0,21,4,74.3,2,2
242,1,1,58,12,59.6,4,8
242,2,1,60,15,60.4,11,4
242,3,1,51,13,57.7,8,5
242,4,1,29,8,57.8,2,6
242,5,1,53,18,57.8,7,11
242,6,1,52,17,56.6,12,5
242,7,1,34,9,58.3,4,5
242,8,1,33,12,57.6,8,4
242,9,1,45,18,56.1,6,12
242,10,1,57,20,55.7,13,7
242,11,1,66,25,56.5,14,11
242,12,1,71,28,59.5,11,17
242,13,1,48,17,57.6,7,10
242,14,1,44,17,56.6,8,9
242,15,1,43,19,52.7,10,9
242,16,1,47,23,55.9,16,7
242,17,1,45,21,56.4,11,10
242,18,1,48,21,61.4,10,11
242,19,1,75,38,56.3,22,16
242,20,1,51,23,57.7,11,12
242,21,1,53,27,56.6,9,18
242,22,1,57,30,59.0,16,14
242,23,1,60,30,55.9,12,18
242,24,1,47,28,57.9,13,15
242,25,1,52,32,58.3,22,10
242,26,1,78,46,57.1,23,23
242,27,1,45,29,62.9,15,14
242,28,1,18,12,56.5,8,4
242,29,1,41,28,53.9,15,13
242,30,1,55,35,55.6,19,16
243,1,0,106,9,31.2,5,4
243,2,0,134,11,32.3,6,5
243,3,0,104,10,37.8,6,4
243,4,0,94,9,34.4,7,2
243,5,0,120,14,29.7,9,5
243,6,0,82,9,31.2,6,3
243,7,0,80,8,32.1,4,4
243,8,0,115,13,32.2,8,5
243,9,0,127,14,33.2,7,7
243,10,0,124,14,32.6,7,7
243,11,0,149,17,35.2,10,7
243,12,0,86,12,28.7,8,4
243,13,0,75,12,33.8,9,3
243,14,0,81,10,34.1,7,3
243,15,0,140,22,32.4,14,8
243,16,0,139,19,34.8,8,11
243,17,0,118,17,33.5,12,5
243,18,0,115,17,34.3,12,5
243,19,0,150,22,33.2,14,8
243,20,0,81,13,31.0,8,5
243,21,0,106,17,35.6,14,3
243,22,0,120,21,38.7,15,6
243,23,0,118,21,32.6,11,10
243,24,0,104,20,31.9,16,4
243,25,0,100,17,32.9,13,4
243,26,0,102,18,34.0,14,4
243,27,0,91,17,32.7,9,8
243,28,0,82,17,32.9,10,7
243,29,0,83,16,34.9,13,3
243,30,0,109,26,37.7,22,4
244,1,0,62,5,75.0,1,4
244,2,0,78,6,74.3,3,3
244,3,0,56,7,73.3,3,4
244,4,0,86,9,75.0,4,5
244,5,0,83,12,77.9,5,7
244,6,0,62,7,77.3,4,3
244,7,0,52,8,73.7,6,2
244,8,0,70,10,79.4,6,4
244,9,0,42,6,76.1,4,2
244,10,0,55,11,77.5,3,8
244,11,0,80,10,74.1,6,4
244,12,0,63,9,76.8,5,4
244,13,0,60,10,76.3,7,3
244,14,0,45,6,75.2,3,3
244,15,0,73,9,85.7,5,4
244,16,0,64,11,73.4,8,3
244,17,0,80,13,74.2,7,6
244,18,0,78,14,73.4,8,6
244,19,0,49,9,73.5,5,4
244,20,0,51,10,75.2,5,5
244,21,0,39,6,74.0,2,4
244,22,0,42,7,75.1,4,3
244,23,0,90,18,73.5,11,7
244,24,0,64,15,77.9,4,11
244,25,0,50,9,74.4,2,7
244,26,0,68,13,69.2,5,8
244,27,0,37,6,74.8,2,4
244,28,0,49,10,72.2,4,6
244,29,0,103,22,74.1,11,11
244,30,0,53,10,71.6,4,6
245,1,0,146,13,29.9,8,5
245,2,0,115,11,30.3,3,8
245,3,0,114,10,32.1,2,8
245,4,0,139,12,32.8,8,4
245,5,0,117,13,31.2,7,6
245,6,0,78,7,29.3,2,5
245,7,0,86,8,33.1,7,1
245,8,0,93,11,33.3,7,4
245,9,0,113,15,30.9,8,7
245,10,0,110,13,28.0,6,7
245,11,0,119,16,35.4,9,7
245,12,0,113,13,29.4,8,5
245,13,0,100,12,30.5,8,4
245,14,0,74,11,35.6,8,3
245,15,0,105,16,30.9,4,12
245,16,0,110,17,32.0,4,13
245,17,0,142,24,31.6,11,13
245,18,0,142,22,30.4,7,15
245,19,0,127,19,28.8,7,12
245,20,0,89,14,32.7,7,7
245,21,0,88,16,31.0,10,6
245,22,0,90,18,30.8,8,10
245,23,0,137,24,28.9,6,18
245,24,0,106,21,33.4,11,10
245,25,0,98,19,32.4,10,9
245,26,0,92,19,27.8,10,9
245,27,0,86,18,27.9,8,10
245,28,0,77,16,32.1,6,10
245,29,0,91,19,29.1,9,10
245,30,0,114,23,28.2,13,10
246,1,1,85,21,46.8,8,13
246,2,1,71,20,48.4,9,11
246,3,1,49,12,53.1,8,4
246,4,1,65,16,52.0,7,9
246,5,1,69,18,48.7,5,13
246,6,1,39,12,51.8,5,7
246,7,1,36,11,47.7,3,8
246,8,1,44,15,53.0,4,11
246,9,1,47,15,51.9,4,11
246,10,1,38,13,50.7,6,7
246,11,1,77,29,50.9,13,16
246,12,1,61,23,47.9,10,13
246,13,1,56,23,51.9,13,10
246,14,1,6,5,50.0,4,1
246,15,1,51,21,55.2,9,12
246,16,1,60,26,47.4,17,9
246,17,1,73,34,51.3,15,19
246,18,1,51,25,54.5,15,10
246,19,1,48,24,54.1,16,8
246,20,1,21,10,52.2,6,4
246,21,1,33,16,50.4,10,6
246,22,1,52,26,46.8,11,15
246,23,1,60,31,48.1,14,17
246,24,1,46,29,51.0,7,22
246,25,1,43,28,52.6,19,9
246,26,1,48,27,50.2,8,19
246,27,1,40,22,48.3,11,11
246,28,1,25,16,50.5,6,10
246,29,1,63,36,50.4,9,27
246,30,1,59,38,48.6,12,26
247,1,0,73,9,57.7,3,6
247,2,0,75,8,55.0,3,5
247,3,0,92,8,53.8,5,3
247,4,0,87,9,56.5,2,7
247,5,0,65,9,58.5,1,8
247,6,0,54,6,54.4,3,3
247,7,0,34,7,55.3,6,1
247,8,0,73,8,55.7,2,6
247,9,0,68,9,54.1,2,7
247,10,0,79,11,58.6,4,7
247,11,0,76,11,56.8,4,7
247,12,0,59,8,55.1,2,6
247,13,0,32,4,53.4,2,2
247,14,0,68,10,56.1,4,6
247,15,0,61,11,46.1,4,7
247,16,0,70,10,56.0,5,5
247,17,0,87,13,57.3,8,5
247,18,0,58,8,55.8,2,6
247,19,0,62,12,57.3,4,8
247,20,0,56,9,50.7,5,4
247,21,0,69,12,56.5,3,9
247,22,0,83,17,56.1,2,15
247,23,0,79,14,52.9,7,7
247,24,0,69,13,54.6,7,6
247,25,0,74,18,54.9,5,13
247,26,0,69,15,56.2,5,10
247,27,0,61,14,57.2,5,9
247,28,0,47,9,52.9,1,8
247,29,0,97,18,55.4,9,9
247,30,0,71,17,56.4,5,12
248,1,1,121,26,62.4,10,16
248,2,1,107,26,63.5,14,12
248,3,1,96,26,60.8,16,10
248,4,1,101,26,61.6,11,15
248,5,1,95,27,64.4,15,12
248,6,1,67,20,64.3,10,10
248,7,1,60,21,58.6,7,14
248,8,1,125,40,63.1,12,28
248,9,1,96,31,63.1,8,23
248,10,1,88,32,66.6,18,14
248,11,1,69,24,62.0,10,14
248,12,1,106,41,59.3,19,22
248,13,1,66,24,62.2,11,13
248,14,1,90,36,65.9,18,18
248,15,1,79,31,73.0,17,14
248,16,1,102,42,62.6,25,17
248,17,1,109,47,62.1,18,29
248,18,1,100,46,64.9,22,24
248,19,1,98,45,63.0,25,20
248,20,1,67,34,62.1,15,19
248,21,1,62,33,63.2,17,16
248,22,1,125,66,63.6,35,31
248,23,1,100,52,61.2,28,24
248,24,1,99,51,65.1,24,27
248,25,1,94,52,62.1,27,25
248,26,1,104,57,69.2,30,27
248,27,1,68,41,64.9,18,23
248,28,1,63,40,62.0,16,24
248,29,1,98,58,62.6,32,26
248,30,1,85,54,65.7,26,28
249,1,0,123,9,27.8,3,6
249,2,0,90,8,27.4,6,2
249,3,0,120,11,25.7,6,5
249,4,0,112,10,26.0,8,2
249,5,0,111,10,30.7,7,3
249,6,0,72,7,23.5,4,3
249,7,0,105,13,23.3,11,2
249,8,0,128,14,27.0,11,3
249,9,0,133,18,31.6,12,6
249,10,0,119,13,23.3,10,3
249,11,0,111,16,28.5,10,6
249,12,0,108,13,27.2,11,2
249,13,0,70,10,23.8,5,5
249,14,0,83,11,27.2,7,4
249,15,0,129,20,30.7,15,5
249,16,0,101,15,23.7,9,6
249,17,0,104,15,29.5,8,7
249,18,0,112,19,30.1,14,5
249,19,0,110,20,27.0,10,10
249,20,0,71,12,28.1,11,1
249,21,0,74,18,27.1,14,4
249,22,0,116,21,28.3,15,6
249,23,0,105,19,25.1,13,6
249,24,0,105,19,24.7,12,7
249,25,0,111,22,27.0,14,8
249,26,0,106,20,24.5,12,8
249,27,0,68,15,28.3,11,4
249,28,0,91,20,28.9,10,10
249,29,0,89,18,27.0,8,10
249,30,0,102,23,29.1,17,6
250,1,0,62,5,43.2,1,4
250,2,0,84,9,36.5,4,5
250,3,0,84,7,38.5,1,6
250,4,0,46,4,40.5,3,1
250,5,0,56,8,36.7,2,6
250,6,0,63,6,40.9,1,5
250,7,0,51,5,38.8,2,3
250,8,0,86,11,40.0,5,6
250,9,0,81,8,41.2,5,3
250,10,0,79,13,36.6,2,11
250,11,0,82,10,43.3,3,7
250,12,0,94,12,40.6,1,11
250,13,0,53,10,39.1,5,5
250,14,0,59,7,39.1,4,3
250,15,0,87,16,41.7,6,10
250,16,0,83,13,39.5,3,10
250,17,0,63,10,36.3,5,5
250,18,0,66,12,37.1,4,8
250,19,0,85,14,39.6,6,8
250,20,0,59,9,40.1,4,5
250,21,0,52,8,41.7,3,5
250,22,0,78,13,38.3,9,4
250,23,0,101,18,38.6,6,12
250,24,0,83,16,37.5,6,10
250,25,0,109,20,37.3,9,11
250,26,0,102,19,38.4,10,9
250,27,0,56,10,40.2,3,7
250,28,0,59,12,37.8,3,9
250,29,0,88,23,34.0,5,18
250,30,0,89,20,39.3,8,12
251,1,0,33,6,64.0,3,3
251,2,0,37,4,66.3,1,3
251,3,0,45,6,63.3,2,4
251,4,0,47,6,64.7,1,5
251,5,0,74,8,64.9,2,6
251,6,0,32,2,67.7,1,1
251,7,0,30,6,64.2,1,5
251,8,0,35,7,63.9,3,4
251,9,0,42,5,64.4,2,3
251,10,0,69,10,68.2,5,5
251,11,0,55,6,66.3,2,4
251,12,0,68,9,64.5,3,6
251,13,0,24,2,65.8,0,2
251,14,0,20,2,63.0,1,1
251,15,0,78,12,60.4,5,7
251,16,0,46,7,66.2,1,6
251,17,0,34,8,66.8,2,6
251,18,0,76,13,63.9,5,8
251,19,0,62,10,72.1,6,4
251,20,0,12,4,65.1,2,2
251,21,0,42,8,66.5,4,4
251,22,0,47,7,67.9,3,4
251,23,0,76,15,68.7,6,9
251,24,0,50,8,64.5,2,6
251,25,0,28,7,65.7,0,7
251,26,0,62,16,63.5,7,9
251,27,0,35,7,65.3,1,6
251,28,0,32,7,66.8,2,5
251,29,0,53,16,65.0,7,9
251,30,0,25,7,68.0,1,6
252,1,1,21,5,58.1,4,1
252,2,1,14,6,54.9,3,3
252,3,1,21,6,57.2,1,5
252,4,1,25,8,55.1,6,2
252,5,1,34,11,56.1,5,6
252,6,1,0,1,51.7,0,1
252,7,1,24,10,55.4,4,6
252,8,1,3,2,56.8,1,1
252,9,1,31,10,58.8,4,6
252,10,1,36,13,51.9,4,9
252,11,1,10,5,52.6,3,2
252,12,1,5,2,54.4,1,1
252,13,1,21,9,56.4,6,3
252,14,1,8,4,53.7,2,2
252,15,1,4,4,58.5,1,3
252,16,1,22,11,54.3,3,8
252,17,1,46,25,51.4,14,11
252,18,1,12,8,53.1,4,4
252,19,1,16,9,54.5,6,3
252,20,1,4,2,55.8,0,2
252,21,1,14,7,55.2,2,5
252,22,1,20,11,54.9,4,7
252,23,1,34,19,55.1,11,8
252,24,1,0,1,56.1,1,0
252,25,1,47,27,55.8,10,17
252,26,1,10,7,57.5,4,3
252,27,1,25,16,56.6,8,8
252,28,1,3,2,55.2,0,2
252,29,1,0,2,54.7,1,1
252,30,1,5,5,56.1,3,2
253,1,0,65,4,65.1,2,2
253,2,0,43,4,64.7,1,3
253,3,0,49,7,65.6,5,2
253,4,0,49,6,67.6,4,2
253,5,0,19,4,63.3,3,1
253,6,0,31,5,65.7,3,2
253,7,0,31,5,65.3,1,4
253,8,0,63,12,65.2,6,6
253,9,0,54,6,61.4,0,6
253,10,0,78,10,64.4,5,5
253,11,0,39,4,65.1,2,2
253,12,0,38,5,67.0,3,2
253,13,0,24,3,63.7,2,1
253,14,0,34,6,63.0,4,2
253,15,0,62,10,71.3,6,4
253,16,0,35,7,66.0,5,2
253,17,0,51,8,67.3,4,4
253,18,0,33,6,63.6,3,3
253,19,0,38,7,63.4,6,1
253,20,0,34,7,66.6,0,7
253,21,0,24,5,64.1,3,2
253,22,0,58,10,68.7,6,4
253,23,0,28,4,64.4,2,2
253,24,0,35,10,63.3,4,6
253,25,0,68,16,64.8,10,6
253,26,0,48,12,66.2,6,6
253,27,0,24,6,64.6,4,2
253,28,0,32,7,61.2,6,1
253,29,0,42,10,63.8,5,5
253,30,0,42,8,62.7,3,5
254,1,0,14,1,30.8,1,0
254,2,0,13,2,30.9,0,2
254,3,0,32,3,27.8,2,1
254,4,0,29,7,29.1,3,4
254,5,0,33,5,29.5,3,2
254,6,0,3,3,29.1,1,2
254,7,0,3,2,29.1,2,0
254,8,0,16,3,28.3,2,1
254,9,0,28,3,30.5,2,1
254,10,0,16,2,26.9,2,0
254,11,0,4,1,30.5,1,0
254,12,0,12,4,27.3,3,1
254,13,0,9,5,30.7,2,3
254,14,0,1,5,34.3,3,2
254,15,0,0,1,28.1,0,1
254,16,0,25,4,31.4,2,2
254,17,0,13,2,29.1,1,1
254,18,0,23,4,27.5,3,1
254,19,0,13,2,29.7,1,1
254,20,0,13,3,28.9,0,3
254,21,0,12,2,33.3,2,0
254,22,0,33,6,26.1,5,1
254,23,0,25,7,33.7,6,1
254,24,0,9,3,30.5,3,0
254,25,0,36,11,29.9,8,3
254,26,0,3,4,30.8,3,1
254,27,0,8,2,29.7,0,2
254,28,0,3,2,30.8,1,1
254,29,0,6,4,29.6,1,3
254,30,0,24,7,32.8,7,0
255,1,0,98,11,22.7,7,4
255,2,0,129,13,21.8,8,5
255,3,0,85,8,25.0,6,2
255,4,0,126,12,19.4,7,5
255,5,0,85,8,25.0,6,2
255,6,0,61,7,24.2,4,3
255,7,0,65,6,18.2,3,3
255,8,0,99,15,24.2,9,6
255,9,0,82,10,21.6,8,2
255,10,0,112,15,21.7,7,8
255,11,0,72,10,21.9,8,2
255,12,0,102,12,23.1,7,5
255,13,0,70,9,22.7,7,2
255,14,0,49,6,24.9,0,6
255,15,0,83,13,25.2,9,4
255,16,0,50,9,23.3,9,0
255,17,0,91,14,23.7,7,7
255,18,0,92,14,22.7,10,4
255,19,0,95,14,21.0,11,3
255,20,0,72,14,23.9,9,5
255,21,0,58,11,25.6,10,1
255,22,0,72,11,25.0,8,3
255,23,0,83,20,23.0,14,6
255,24,0,106,18,23.1,11,7
255,25,0,87,16,22.0,11,5
255,26,0,95,19,25.7,15,4
255,27,0,64,12,26.6,6,6
255,28,0,43,9,22.1,6,3
255,29,0,65,14,21.5,6,8
255,30,0,86,19,22.7,15,4
256,1,0,51,5,68.7,3,2
256,2,0,87,7,69.9,3,4
256,3,0,66,7,73.7,3,4
256,4,0,80,9,66.5,6,3
256,5,0,84,10,67.9,3,7
256,6,0,41,4,69.5,0,4
256,7,0,46,8,72.3,4,4
256,8,0,65,11,69.7,6,5
256,9,0,38,6,70.9,3,3
256,10,0,68,9,71.3,5,4
256,11,0,54,12,69.9,6,6
256,12,0,63,7,68.2,4,3
256,13,0,53,6,66.2,1,5
256,14,0,50,11,69.8,2,9
256,15,0,77,11,69.7,5,6
256,16,0,73,13,70.4,9,4
256,17,0,82,18,72.7,9,9
256,18,0,74,14,71.0,10,4
256,19,0,52,8,70.6,4,4
256,20,0,45,6,69.0,2,4
256,21,0,33,7,66.5,3,4
256,22,0,69,12,70.4,9,3
256,23,0,51,10,71.4,5,5
256,24,0,50,10,70.3,6,4
256,25,0,49,9,69.5,4,5
256,26,0,59,13,71.4,7,6
256,27,0,41,10,70.6,6,4
256,28,0,62,11,72.6,7,4
256,29,0,77,18,70.6,8,10
256,30,0,53,14,69.8,6,8
257,1,0,88,10,53.8,8,2
257,2,0,103,7,55.4,2,5
257,3,0,91,9,50.7,3,6
257,4,0,103,11,52.8,7,4
257,5,0,103,10,54.5,5,5
257,6,0,59,8,50.0,6,2
257,7,0,54,7,53.9,4,3
257,8,0,66,9,57.7,6,3
257,9,0,68,8,56.3,3,5
257,10,0,77,8,54.4,6,2
257,11,0,98,14,54.1,7,7
257,12,0,92,11,52.6,7,4
257,13,0,75,9,56.0,6,3
257,14,0,69,9,54.0,7,2
257,15,0,68,12,51.6,9,3
257,16,0,102,14,53.9,10,4
257,17,0,87,13,56.3,8,5
257,18,0,109,15,57.6,9,6
257,19,0,78,12,51.7,7,5
257,20,0,76,13,56.0,8,5
257,21,0,74,15,51.7,11,4
257,22,0,90,18,53.3,11,7
257,23,0,83,14,54.6,7,7
257,24,0,102,18,51.5,12,6
257,25,0,96,19,52.4,11,8
257,26,0,88,17,54.6,11,6
257,27,0,62,13,55.3,9,4
257,28,0,54,13,53.8,8,5
257,29,0,78,16,56.4,11,5
257,30,0,70,15,55.2,11,4
258,1,0,126,11,67.7,10,1
258,2,0,125,11,63.9,9,2
258,3,0,92,14,70.6,12,2
258,4,0,132,13,64.1,9,4
258,5,0,119,11,66.5,7,4
258,6,0,92,12,64.9,8,4
258,7,0,78,12,66.4,8,4
258,8,0,118,12,66.6,7,5
258,9,0,114,14,69.7,10,4
258,10,0,104,12,64.0,7,5
258,11,0,119,15,66.6,9,6
258,12,0,125,21,70.3,17,4
258,13,0,88,14,67.1,8,6
258,14,0,82,10,70.1,5,5
258,15,0,110,15,62.9,9,6
258,16,0,116,19,67.1,12,7
258,17,0,119,18,68.1,15,3
258,18,0,117,18,63.9,14,4
258,19,0,114,19,65.8,10,9
258,20,0,81,13,66.6,8,5
258,21,0,73,11,63.6,6,5
258,22,0,129,25,68.3,14,11
258,23,0,123,22,66.5,16,6
258,24,0,115,19,65.9,13,6
258,25,0,115,22,68.7,19,3
258,26,0,100,19,69.6,15,4
258,27,0,72,16,68.9,13,3
258,28,0,75,16,66.1,11,5
258,29,0,119,26,66.9,18,8
258,30,0,145,32,69.7,21,11
259,1,0,126,8,31.9,3,5
259,2,0,123,10,32.4,4,6
259,3,0,88,7,31.5,4,3
259,4,0,95,9,31.7,7,2
259,5,0,141,15,29.7,5,10
259,6,0,83,7,33.2,3,4
259,7,0,62,9,30.1,4,5
259,8,0,121,14,32.6,5,9
259,9,0,143,15,32.0,5,10
259,10,0,90,13,31.2,9,4
259,11,0,122,16,32.4,8,8
259,12,0,103,17,29.4,5,12
259,13,0,79,9,30.5,3,6
259,14,0,74,11,30.1,3,8
259,15,0,115,17,21.1,7,10
259,16,0,99,15,35.5,8,7
259,17,0,134,21,29.3,10,11
259,18,0,80,14,29.2,6,8
259,19,0,109,17,27.8,6,11
259,20,0,77,14,33.0,7,7
259,21,0,59,11,31.7,6,5
259,22,0,105,19,30.0,11,8
259,23,0,133,25,29.6,13,12
259,24,0,118,23,30.3,10,13
259,25,0,113,21,32.6,11,10
259,26,0,122,25,27.4,14,11
259,27,0,89,18,31.6,10,8
259,28,0,75,15,29.4,9,6
259,29,0,87,23,31.6,16,7
259,30,0,101,20,29.0,13,7
260,1,0,123,10,73.4,7,3
260,2,0,111,9,69.7,5,4
260,3,0,96,8,68.2,6,2
260,4,0,111,12,70.5,5,7
260,5,0,113,11,71.4,5,6
260,6,0,88,11,68.7,6,5
260,7,0,81,9,68.7,5,4
260,8,0,99,12,73.1,4,8
260,9,0,97,11,70.5,7,4
260,10,0,95,10,69.7,5,5
260,11,0,97,14,72.3,5,9
260,12,0,109,13,68.8,3,10
260,13,0,75,10,69.7,3,7
260,14,0,68,8,69.5,4,4
260,15,0,142,18,70.2,7,11
260,16,0,110,18,66.8,12,6
260,17,0,134,22,70.4,12,10
260,18,0,115,17,66.0,9,8
260,19,0,100,17,71.8,7,10
260,20,0,79,14,68.7,7,7
260,21,0,78,15,70.1,7,8
260,22,0,132,23,70.1,14,9
260,23,0,143,27,69.4,12,15
260,24,0,126,22,69.4,11,11
260,25,0,111,19,69.5,12,7
260,26,0,98,20,66.7,10,10
260,27,0,63,12,70.1,8,4
260,28,0,67,14,67.4,8,6
260,29,0,94,19,67.8,8,11
260,30,0,111,24,71.5,15,9
261,1,0,64,5,73.1,5,0
261,2,0,50,5,70.4,3,2
261,3,0,69,5,72.2,3,2
261,4,0,67,6,72.6,2,4
261,5,0,83,8,72.6,4,4
261,6,0,50,5,70.9,5,0
261,7,0,43,7,67.2,5,2
261,8,0,58,6,74.0,4,2
261,9,0,71,7,71.0,4,3
261,10,0,86,9,71.6,8,1
261,11,0,50,8,70.4,6,2
261,12,0,70,10,71.1,9,1
261,13,0,37,9,74.1,8,1
261,14,0,40,5,73.0,2,3
261,15,0,62,8,76.5,6,2
261,16,0,95,15,70.7,10,5
261,17,0,60,9,72.0,7,2
261,18,0,62,12,71.5,4,8
261,19,0,71,12,72.6,7,5
261,20,0,39,6,70.5,3,3
261,21,0,63,12,74.8,5,7
261,22,0,75,15,73.2,9,6
261,23,0,114,21,71.2,17,4
261,24,0,38,8,71.9,6,2
261,25,0,61,13,72.8,10,3
261,26,0,60,10,71.0,6,4
261,27,0,58,10,69.7,8,2
261,28,0,60,13,68.4,9,4
261,29,0,64,14,73.5,9,5
261,30,0,72,14,70.4,5,9
262,1,0,59,5,57.9,4,1
262,2,0,38,2,61.1,2,0
262,3,0,53,5,59.6,4,1
262,4,0,50,6,58.0,5,1
262,5,0,42,4,55.6,4,0
262,6,0,31,4,58.0,4,0
262,7,0,40,3,55.8,3,0
262,8,0,52,9,55.4,6,3
262,9,0,40,8,58.6,6,2
262,10,0,32,4,58.8,4,0
262,11,0,64,9,55.6,6,3
262,12,0,53,7,57.8,4,3
262,13,0,47,6,56.8,5,1
262,14,0,31,7,57.1,4,3
262,15,0,49,8,47.4,5,3
262,16,0,39,7,57.1,6,1
262,17,0,56,9,55.7,4,5
262,18,0,57,12,57.9,8,4
262,19,0,54,12,56.1,10,2
262,20,0,54,10,59.6,9,1
262,21,0,19,6,57.7,3,3
262,22,0,39,8,59.4,7,1
262,23,0,58,11,60.7,5,6
262,24,0,38,9,61.1,6,3
262,25,0,27,7,57.9,2,5
262,26,0,61,11,56.5,9,2
262,27,0,32,8,56.0,4,4
262,28,0,35,9,60.2,6,3
262,29,0,64,13,60.6,10,3
262,30,0,46,11,54.7,5,6
263,1,0,17,4,55.0,3,1
263,2,0,33,3,53.2,2,1
263,3,0,33,5,55.1,4,1
263,4,0,40,4,54.6,4,0
263,5,0,18,4,56.4,3,1
263,6,0,17,4,56.5,4,0
263,7,0,38,6,51.6,5,1
263,8,0,22,4,55.4,2,2
263,9,0,16,2,57.1,2,0
263,10,0,32,5,58.7,3,2
263,11,0,10,1,58.5,1,0
263,12,0,9,2,50.8,1,1
263,13,0,18,6,56.1,4,2
263,14,0,0,5,53.6,2,3
263,15,0,28,8,47.4,6,2
263,16,0,15,3,55.2,3,0
263,17,0,35,6,57.1,4,2
263,18,0,36,11,57.6,6,5
263,19,0,0,3,55.7,2,1
263,20,0,28,7,56.5,4,3
263,21,0,23,6,58.1,4,2
263,22,0,36,7,58.6,6,1
263,23,0,33,5,55.4,3,2
263,24,0,30,6,53.6,5,1
263,25,0,39,10,56.1,7,3
263,26,0,16,5,55.6,3,2
263,27,0,18,6,57.5,4,2
263,28,0,21,6,58.6,2,4
263,29,0,38,10,62.3,8,2
263,30,0,35,8,52.5,6,2
264,1,1,59,12,21.2,5,7
264,2,1,58,14,22.5,3,11
264,3,1,71,18,20.3,7,11
264,4,1,57,15,24.0,7,8
264,5,1,70,19,20.4,13,6
264,6,1,45,13,24.4,8,5
264,7,1,48,16,21.6,10,6
264,8,1,57,19,21.9,8,11
264,9,1,61,24,22.5,12,12
264,10,1,55,20,22.5,12,8
264,11,1,72,28,25.0,12,16
264,12,1,50,19,20.3,6,13
264,13,1,36,13,23.3,7,6
264,14,1,50,23,26.6,12,11
264,15,1,74,31,36.1,19,12
264,16,1,60,26,22.2,5,21
264,17,1,53,25,20.7,17,8
264,18,1,56,25,20.6,11,14
264,19,1,60,30,22.3,15,15
264,20,1,52,31,24.6,15,16
264,21,1,48,25,22.3,13,12
264,22,1,61,30,19.2,15,15
264,23,1,100,52,22.8,24,28
264,24,1,71,38,22.4,15,23
264,25,1,72,40,21.8,18,22
264,26,1,60,34,22.8,10,24
264,27,1,45,30,23.6,14,16
264,28,1,24,16,24.0,9,7
264,29,1,69,45,19.9,15,30
264,30,1,74,44,23.6,29,15
265,1,1,67,19,75.8,10,9
265,2,1,26,10,75.6,5,5
265,3,1,32,7,75.5,5,2
265,4,1,56,16,75.9,4,12
265,5,1,36,11,79.0,0,11
265,6,1,31,10,78.6,6,4
265,7,1,23,10,78.1,6,4
265,8,1,58,17,74.2,9,8
265,9,1,55,18,75.0,9,9
265,10,1,50,17,79.3,9,8
265,11,1,58,21,77.6,8,13
265,12,1,41,16,73.6,7,9
265,13,1,17,6,80.9,5,1
265,14,1,35,15,74.8,4,11
265,15,1,51,23,84.7,12,11
265,16,1,64,29,77.6,14,15
265,17,1,66,28,74.7,12,16
265,18,1,47,22,77.2,10,12
265,19,1,74,35,77.2,20,15
265,20,1,41,19,74.8,5,14
265,21,1,45,23,79.2,4,19
265,22,1,65,37,77.3,18,19
265,23,1,33,17,75.4,6,11
265,24,1,75,41,79.7,25,16
265,25,1,76,41,78.8,21,20
265,26,1,46,29,82.1,14,15
265,27,1,21,11,78.4,5,6
265,28,1,45,27,77.0,14,13
265,29,1,39,24,74.2,10,14
265,30,1,24,15,78.8,7,8
266,1,0,72,6,63.1,3,3
266,2,0,105,10,62.4,6,4
266,3,0,89,8,59.0,7,1
266,4,0,93,9,62.1,7,2
266,5,0,89,8,59.3,5,3
266,6,0,48,5,57.6,4,1
266,7,0,60,7,64.2,3,4
266,8,0,113,14,63.7,8,6
266,9,0,90,11,63.0,8,3
266,10,0,89,12,59.9,7,5
266,11,0,89,10,61.2,6,4
266,12,0,96,11,59.1,6,5
266,13,0,46,8,57.4,5,3
266,14,0,61,12,64.6,9,3
266,15,0,85,15,62.9,7,8
266,16,0,83,12,60.3,7,5
266,17,0,75,14,60.2,11,3
266,18,0,80,13,60.5,8,5
266,19,0,91,14,56.8,10,4
266,20,0,64,11,61.2,7,4
266,21,0,53,11,59.5,7,4
266,22,0,128,22,59.6,19,3
266,23,0,74,13,61.0,9,4
266,24,0,47,9,61.1,6,3
266,25,0,81,17,59.2,12,5
266,26,0,83,17,63.0,11,6
266,27,0,58,12,60.6,10,2
266,28,0,68,15,61.5,12,3
266,29,0,70,17,60.0,12,5
266,30,0,100,21,62.4,16,5
267,1,1,118,29,75.1,12,17
267,2,1,84,19,80.4,9,10
267,3,1,118,30,78.6,15,15
267,4,1,91,26,80.7,14,12
267,5,1,92,25,78.3,10,15
267,6,1,72,23,77.0,16,7
267,7,1,93,29,78.6,19,10
267,8,1,85,30,76.7,18,12
267,9,1,91,30,81.0,10,20
267,10,1,120,43,75.3,21,22
267,11,1,115,40,77.8,20,20
267,12,1,93,37,79.6,19,18
267,13,1,61,27,76.1,17,10
267,14,1,83,32,79.6,12,20
267,15,1,129,54,68.4,26,28
267,16,1,106,47,76.1,24,23
267,17,1,94,42,76.6,19,23
267,18,1,90,39,76.3,22,17
267,19,1,94,44,74.7,19,25
267,20,1,75,34,78.7,20,14
267,21,1,67,33,74.7,18,15
267,22,1,96,48,79.6,26,22
267,23,1,84,44,76.8,19,25
267,24,1,97,50,75.3,25,25
267,25,1,124,67,78.0,40,27
267,26,1,107,60,78.3,27,33
267,27,1,69,38,77.6,21,17
267,28,1,85,50,75.7,27,23
267,29,1,114,67,78.0,27,40
267,30,1,113,67,75.2,30,37
268,1,0,80,6,24.0,5,1
268,2,0,81,7,31.7,4,3
268,3,0,60,6,31.3,5,1
268,4,0,49,5,26.9,5,0
268,5,0,50,8,28.0,5,3
268,6,0,57,8,30.1,4,4
268,7,0,48,7,28.8,6,1
268,8,0,87,11,31.5,8,3
268,9,0,74,7,31.9,5,2
268,10,0,53,5,32.0,3,2
268,11,0,74,9,25.8,5,4
268,12,0,89,11,25.3,4,7
268,13,0,42,7,29.5,5,2
268,14,0,48,10,29.2,4,6
268,15,0,64,12,35.4,9,3
268,16,0,102,16,29.4,9,7
268,17,0,80,13,30.5,8,5
268,18,0,38,7,30.3,3,4
268,19,0,66,13,27.4,7,6
268,20,0,48,10,24.1,7,3
268,21,0,62,11,28.5,5,6
268,22,0,64,12,28.3,8,4
268,23,0,62,12,25.3,6,6
268,24,0,64,14,25.2,10,4
268,25,0,76,15,27.9,8,7
268,26,0,82,18,28.9,12,6
268,27,0,67,15,28.2,8,7
268,28,0,39,10,30.4,4,6
268,29,0,72,17,25.5,11,6
268,30,0,57,11,30.0,6,5
269,1,0,61,7,39.7,2,5
269,2,0,79,7,34.2,3,4
269,3,0,103,9,34.6,4,5
269,4,0,89,8,34.1,1,7
269,5,0,59,7,34.5,3,4
269,6,0,46,5,34.9,2,3
269,7,0,56,6,31.9,3,3
269,8,0,89,9,38.2,5,4
269,9,0,80,10,34.3,5,5
269,10,0,95,10,33.2,4,6
269,11,0,102,15,31.7,10,5
269,12,0,79,9,37.5,8,1
269,13,0,62,10,37.5,7,3
269,14,0,54,7,32.7,4,3
269,15,0,97,15,34.1,9,6
269,16,0,78,12,36.4,7,5
269,17,0,85,14,34.9,9,5
269,18,0,91,15,34.8,6,9
269,19,0,93,15,34.6,9,6
269,20,0,34,7,31.4,4,3
269,21,0,61,13,36.7,12,1
269,22,0,74,13,30.7,6,7
269,23,0,82,18,29.1,6,12
269,24,0,84,17,33.9,11,6
269,25,0,87,18,34.6,9,9
269,26,0,88,18,35.0,10,8
269,27,0,37,7,34.9,4,3
269,28,0,59,13,35.4,10,3
269,29,0,61,13,34.5,5,8
269,30,0,78,16,36.6,8,8
270,1,1,57,15,52.1,9,6
270,2,1,37,8,49.8,3,5
270,3,1,48,13,51.7,4,9
270,4,1,56,16,53.8,10,6
270,5,1,50,16,54.3,4,12
270,6,1,19,7,49.4,3,4
270,7,1,28,10,51.7,7,3
270,8,1,48,16,51.4,9,7
270,9,1,44,17,54.0,9,8
270,10,1,35,17,51.4,5,12
270,11,1,56,19,51.9,11,8
270,12,1,61,22,52.0,10,12
270,13,1,36,16,55.9,10,6
270,14,1,60,25,51.8,13,12
270,15,1,49,20,65.5,7,13
270,16,1,36,16,48.7,8,8
270,17,1,52,22,50.1,10,12
270,18,1,76,36,52.7,15,21
270,19,1,58,29,51.5,18,11
270,20,1,25,12,53.9,8,4
270,21,1,26,12,51.3,4,8
270,22,1,68,38,55.7,22,16
270,23,1,53,29,52.7,19,10
270,24,1,25,14,51.7,10,4
270,25,1,43,25,53.5,9,16
270,26,1,68,40,50.7,23,17
270,27,1,32,19,55.0,11,8
270,28,1,27,17,53.9,10,7
270,29,1,34,22,50.2,9,13
270,30,1,67,43,49.5,23,20
271,1,1,80,19,54.3,10,9
271,2,1,97,24,53.8,12,12
271,3,1,131,33,54.3,18,15
271,4,1,103,28,57.5,13,15
271,5,1,128,37,57.9,16,21
271,6,1,75,23,52.5,15,8
271,7,1,66,22,57.9,11,11
271,8,1,106,35,52.9,19,16
271,9,1,101,33,52.1,18,15
271,10,1,100,36,51.5,13,23
271,11,1,92,31,56.1,14,17
271,12,1,114,41,52.0,20,21
271,13,1,90,36,53.7,20,16
271,14,1,60,25,54.0,15,10
271,15,1,90,38,53.8,19,19
271,16,1,106,45,53.8,19,26
271,17,1,92,41,55.7,19,22
271,18,1,128,59,54.0,29,30
271,19,1,84,39,52.3,13,26
271,20,1,88,44,54.8,26,18
271,21,1,91,45,55.0,24,21
271,22,1,78,39,54.6,15,24
271,23,1,124,64,53.8,24,40
271,24,1,111,57,51.4,32,25
271,25,1,99,52,54.7,33,19
271,26,1,118,66,59.3,30,36
271,27,1,64,38,56.4,27,11
271,28,1,70,42,56.2,21,21
271,29,1,98,58,52.1,31,27
271,30,1,97,59,54.5,30,29
272,1,0,6,1,68.5,1,0
272,2,0,32,5,69.2,3,2
272,3,0,32,3,70.6,1,2
272,4,0,3,1,70.4,0,1
272,5,0,32,2,74.4,2,0
272,6,0,0,3,72.8,0,3
272,7,0,11,2,73.5,2,0
272,8,0,28,2,68.0,0,2
272,9,0,0,1,70.2,0,1
272,10,0,0,2,68.5,1,1
272,11,0,17,3,67.5,1,2
272,12,0,1,2,71.1,0,2
272,13,0,4,3,72.7,1,2
272,14,0,13,3,68.8,1,2
272,15,0,16,2,69.4,0,2
272,16,0,0,2,68.9,1,1
272,17,0,28,5,68.9,1,4
272,18,0,3,5,72.4,2,3
272,19,0,0,0,65.7,0,0
272,20,0,0,1,70.0,1,0
272,21,0,23,5,72.1,2,3
272,22,0,1,3,73.8,2,1
272,23,0,23,3,70.3,0,3
272,24,0,4,1,70.5,1,0
272,25,0,1,1,68.7,0,1
272,26,0,22,6,72.9,1,5
272,27,0,9,3,70.8,1,2
272,28,0,1,3,71.5,2,1
272,29,0,0,2,68.9,1,1
272,30,0,8,2,70.8,1,1
273,1,1,18,4,27.2,1,3
273,2,1,4,2,27.3,2,0
273,3,1,35,9,28.0,5,4
273,4,1,25,7,29.2,3,4
273,5,1,46,15,28.7,9,6
273,6,1,16,6,29.0,4,2
273,7,1,11,5,27.9,3,2
273,8,1,8,5,31.1,1,4
273,9,1,29,11,29.1,5,6
273,10,1,24,11,31.4,1,10
273,11,1,22,9,27.8,6,3
273,12,1,41,18,28.2,7,11
273,13,1,33,14,30.0,7,7
273,14,1,12,6,29.2,1,5
273,15,1,18,7,25.4,3,4
273,16,1,20,10,26.4,5,5
273,17,1,30,13,28.1,7,6
273,18,1,29,15,27.4,7,8
273,19,1,28,14,28.4,7,7
273,20,1,7,3,25.9,1,2
273,21,1,5,5,25.4,0,5
273,22,1,22,12,30.3,6,6
273,23,1,14,10,28.9,7,3
273,24,1,28,17,27.6,13,4
273,25,1,35,21,30.2,8,13
273,26,1,26,16,30.3,8,8
273,27,1,26,14,28.5,3,11
273,28,1,15,8,26.1,4,4
273,29,1,7,8,32.8,4,4
273,30,1,29,18,24.9,8,10
274,1,0,103,7,53.4,0,7
274,2,0,101,9,53.0,7,2
274,3,0,81,6,49.6,1,5
274,4,0,104,9,52.6,2,7
274,5,0,113,12,51.0,2,10
274,6,0,58,6,51.1,1,5
274,7,0,53,8,52.2,4,4
274,8,0,104,11,49.4,3,8
274,9,0,97,10,50.2,2,8
274,10,0,91,11,53.8,4,7
274,11,0,79,11,52.9,5,6
274,12,0,97,13,53.4,2,11
274,13,0,61,10,53.5,4,6
274,14,0,54,8,51.9,5,3
274,15,0,110,15,42.4,5,10
274,16,0,105,15,53.0,3,12
274,17,0,67,11,48.7,1,10
274,18,0,127,20,55.7,5,15
274,19,0,100,16,54.1,6,10
274,20,0,78,15,51.0,7,8
274,21,0,67,10,54.5,4,6
274,22,0,82,14,51.6,3,11
274,23,0,82,17,53.1,5,12
274,24,0,87,16,55.7,6,10
274,25,0,110,21,50.1,12,9
274,26,0,121,26,50.7,8,18
274,27,0,88,18,52.6,5,13
274,28,0,70,16,51.5,5,11
274,29,0,88,19,51.3,7,12
274,30,0,106,23,53.9,5,18
275,1,0,63,5,68.4,2,3
275,2,0,43,7,68.4,5,2
275,3,0,21,4,64.5,1,3
275,4,0,55,6,66.0,1,5
275,5,0,18,3,67.1,2,1
275,6,0,34,6,64.1,0,6
275,7,0,40,5,69.3,0,5
275,8,0,60,7,66.8,3,4
275,9,0,50,12,64.6,5,7
275,10,0,33,5,68.8,2,3
275,11,0,27,4,65.1,2,2
275,12,0,41,6,65.5,3,3
275,13,0,17,2,65.5,1,1
275,14,0,18,5,64.8,2,3
275,15,0,68,12,60.8,5,7
275,16,0,53,7,70.9,3,4
275,17,0,51,9,64.5,2,7
275,18,0,67,10,63.9,3,7
275,19,0,28,4,66.9,1,3
275,20,0,32,6,66.2,3,3
275,21,0,35,6,64.9,1,5
275,22,0,15,7,65.4,2,5
275,23,0,38,12,63.9,4,8
275,24,0,48,9,70.8,2,7
275,25,0,48,9,65.1,5,4
275,26,0,20,4,62.9,0,4
275,27,0,44,8,67.3,2,6
275,28,0,44,9,66.1,6,3
275,29,0,54,13,66.7,5,8
275,30,0,35,12,64.6,3,9
276,1,0,55,3,25.7,1,2
276,2,0,35,6,23.1,2,4
276,3,0,33,2,26.7,0,2
276,4,0,38,5,25.7,0,5
276,5,0,42,5,25.9,2,3
276,6,0,5,2,23.9,2,0
276,7,0,20,2,23.2,1,1
276,8,0,1,3,25.6,2,1
276,9,0,0,2,24.7,1,1
276,10,0,42,5,26.2,0,5
276,11,0,32,4,26.4,2,2
276,12,0,34,6,23.6,3,3
276,13,0,10,5,21.3,1,4
276,14,0,0,1,21.4,0,1
276,15,0,50,6,22.1,2,4
276,16,0,34,5,21.9,0,5
276,17,0,30,6,23.1,1,5
276,18,0,70,12,23.9,2,10
276,19,0,47,9,24.1,4,5
276,20,0,3,2,25.1,0,2
276,21,0,28,6,26.4,0,6
276,22,0,32,7,22.4,1,6
276,23,0,31,5,25.6,1,4
276,24,0,41,10,25.3,2,8
276,25,0,25,6,23.3,2,4
276,26,0,39,12,24.4,4,8
276,27,0,23,5,21.9,1,4
276,28,0,21,5,22.2,1,4
276,29,0,23,6,26.1,2,4
276,30,0,42,10,26.0,4,6
277,1,0,109,10,30.6,2,8
277,2,0,76,9,26.3,5,4
277,3,0,92,9,27.7,2,7
277,4,0,80,6,32.1,2,4
277,5,0,107,10,29.0,5,5
277,6,0,39,3,30.8,0,3
277,7,0,63,9,27.3,3,6
277,8,0,98,15,30.0,2,13
277,9,0,93,12,30.0,6,6
277,10,0,69,10,30.1,3,7
277,11,0,82,11,28.4,3,8
277,12,0,98,13,28.6,5,8
277,13,0,64,9,28.4,4,5
277,14,0,68,9,27.5,1,8
277,15,0,98,14,38.3,8,6
277,16,0,89,12,31.2,3,9
277,17,0,89,14,29.8,7,7
277,18,0,102,19,27.1,5,14
277,19,0,93,17,28.8,4,13
277,20,0,60,10,28.0,7,3
277,21,0,55,11,28.4,2,9
277,22,0,73,14,29.0,5,9
277,23,0,84,18,28.2,6,12
277,24,0,95,16,27.1,5,11
277,25,0,76,15,31.2,1,14
277,26,0,88,17,28.7,5,12
277,27,0,45,13,29.9,2,11
277,28,0,38,10,29.2,7,3
277,29,0,55,12,29.9,2,10
277,30,0,77,17,27.8,8,9
278,1,0,64,5,19.5,2,3
278,2,0,80,7,18.6,7,0
278,3,0,104,12,24.1,8,4
278,4,0,79,7,20.8,3,4
278,5,0,109,11,17.6,5,6
278,6,0,70,8,20.7,4,4
278,7,0,57,7,22.4,4,3
278,8,0,83,10,24.7,4,6
278,9,0,94,11,23.5,5,6
278,10,0,118,16,19.0,3,13
278,11,0,103,16,18.3,9,7
278,12,0,74,10,21.8,6,4
278,13,0,70,8,22.4,3,5
278,14,0,54,6,19.9,3,3
278,15,0,67,10,23.1,4,6
278,16,0,83,12,21.6,9,3
278,17,0,91,14,22.5,11,3
278,18,0,96,15,19.6,7,8
278,19,0,86,14,21.9,6,8
278,20,0,84,13,22.8,6,7
278,21,0,87,15,18.8,7,8
278,22,0,83,14,20.8,10,4
278,23,0,96,19,24.4,7,12
278,24,0,110,22,20.1,11,11
278,25,0,93,19,21.2,6,13
278,26,0,72,16,21.1,8,8
278,27,0,65,13,20.8,4,9
278,28,0,70,18,22.1,10,8
278,29,0,84,16,22.8,8,8
278,30,0,88,21,22.3,13,8
279,1,0,123,11,49.5,5,6
279,2,0,121,13,47.8,5,8
279,3,0,128,13,54.8,6,7
279,4,0,118,12,48.3,5,7
279,5,0,118,13,47.2,4,9
279,6,0,83,9,48.3,2,7
279,7,0,94,9,50.1,3,6
279,8,0,128,14,49.9,3,11
279,9,0,123,14,51.1,2,12
279,10,0,94,12,48.2,7,5
279,11,0,104,14,48.6,5,9
279,12,0,103,17,50.2,4,13
279,13,0,76,12,50.3,3,9
279,14,0,89,15,47.4,5,10
279,15,0,114,23,48.2,12,11
279,16,0,105,17,47.9,7,10
279,17,0,127,20,50.6,10,10
279,18,0,140,21,51.8,9,12
279,19,0,119,20,51.8,9,11
279,20,0,74,14,44.8,7,7
279,21,0,81,15,45.2,5,10
279,22,0,111,22,46.3,8,14
279,23,0,112,21,52.2,6,15
279,24,0,115,21,46.9,6,15
279,25,0,114,24,49.3,7,17
279,26,0,127,30,49.9,8,22
279,27,0,76,14,50.3,8,6
279,28,0,80,17,50.8,2,15
279,29,0,121,26,46.8,10,16
279,30,0,122,26,48.2,9,17
280,1,0,62,5,36.8,1,4
280,2,0,52,4,37.2,2,2
280,3,0,49,4,41.0,4,0
280,4,0,39,7,37.2,4,3
280,5,0,40,5,38.7,1,4
280,6,0,30,3,37.9,1,2
280,7,0,43,6,36.3,1,5
280,8,0,64,9,36.4,2,7
280,9,0,20,2,36.8,0,2
280,10,0,56,10,38.4,1,9
280,11,0,73,9,39.7,3,6
280,12,0,44,6,36.7,6,0
280,13,0,42,9,34.3,3,6
280,14,0,42,10,32.7,5,5
280,15,0,88,12,35.0,1,11
280,16,0,72,10,35.0,3,7
280,17,0,29,6,33.9,2,4
280,18,0,72,11,32.0,5,6
280,19,0,61,11,34.7,3,8
280,20,0,33,6,38.4,1,5
280,21,0,43,7,40.0,4,3
280,22,0,55,9,40.6,2,7
280,23,0,48,10,39.1,5,5
280,24,0,59,12,36.2,5,7
280,25,0,37,7,36.8,1,6
280,26,0,57,12,36.0,4,8
280,27,0,39,8,36.4,2,6
280,28,0,41,10,36.2,2,8
280,29,0,78,18,32.9,2,16
280,30,0,25,7,36.8,2,5
281,1,0,116,9,33.3,4,5
281,2,0,99,8,33.2,2,6
281,3,0,120,10,34.0,2,8
281,4,0,106,9,31.2,4,5
281,5,0,123,11,31.4,3,8
281,6,0,85,8,32.1,2,6
281,7,0,64,6,32.7,3,3
281,8,0,95,12,33.7,4,8
281,9,0,112,12,34.0,8,4
281,10,0,117,14,32.7,5,9
281,11,0,123,16,31.1,5,11
281,12,0,110,15,36.7,5,10
281,13,0,79,9,33.8,2,7
281,14,0,75,9,33.2,4,5
281,15,0,123,16,30.6,6,10
281,16,0,78,13,35.9,6,7
281,17,0,95,15,33.0,8,7
281,18,0,95,14,34.4,6,8
281,19,0,103,16,30.3,6,10
281,20,0,59,12,33.2,4,8
281,21,0,73,15,36.5,8,7
281,22,0,119,21,36.1,9,12
281,23,0,107,20,33.3,7,13
281,24,0,154,29,35.2,9,20
281,25,0,109,21,36.1,9,12
281,26,0,103,19,31.1,8,11
281,27,0,76,18,35.7,7,11
281,28,0,81,18,31.9,7,11
281,29,0,136,26,32.2,11,15
281,30,0,102,22,36.3,10,12
282,1,1,44,11,57.7,6,5
282,2,1,26,7,56.5,4,3
282,3,1,48,15,52.9,9,6
282,4,1,25,9,56.5,3,6
282,5,1,38,10,56.0,5,5
282,6,1,22,9,56.8,4,5
282,7,1,20,8,56.2,5,3
282,8,1,46,15,55.6,6,9
282,9,1,32,12,57.5,11,1
282,10,1,48,16,60.3,12,4
282,11,1,22,9,54.9,5,4
282,12,1,27,9,60.9,3,6
282,13,1,48,18,56.9,9,9
282,14,1,25,11,60.1,6,5
282,15,1,35,16,60.8,12,4
282,16,1,45,20,60.0,10,10
282,17,1,0,2,55.4,1,1
282,18,1,29,14,55.7,7,7
282,19,1,47,23,55.0,13,10
282,20,1,24,11,58.2,7,4
282,21,1,10,5,57.7,1,4
282,22,1,22,12,57.9,6,6
282,23,1,0,0,55.9,0,0
282,24,1,54,28,57.4,16,12
282,25,1,25,14,55.4,6,8
282,26,1,18,12,54.1,8,4
282,27,1,9,7,60.3,4,3
282,28,1,15,12,58.2,3,9
282,29,1,30,18,59.6,11,7
282,30,1,15,12,56.5,6,6
283,1,0,15,3,77.6,2,1
283,2,0,15,4,75.2,3,1
283,3,0,39,4,78.1,3,1
283,4,0,19,2,73.0,1,1
283,5,0,10,2,75.7,2,0
283,6,0,10,2,73.6,2,0
283,7,0,17,1,76.8,1,0
283,8,0,35,4,75.3,2,2
283,9,0,23,5,72.4,5,0
283,10,0,18,4,78.2,4,0
283,11,0,0,0,73.2,0,0
283,12,0,1,5,74.6,3,2
283,13,0,13,1,74.0,0,1
283,14,0,21,2,80.0,1,1
283,15,0,12,5,82.3,4,1
283,16,0,2,2,74.6,1,1
283,17,0,1,3,77.4,3,0
283,18,0,34,7,72.7,5,2
283,19,0,9,4,72.9,3,1
283,20,0,11,4,75.5,3,1
283,21,0,20,4,76.7,4,0
283,22,0,2,2,73.5,0,2
283,23,0,37,7,74.0,6,1
283,24,0,24,6,80.4,6,0
283,25,0,18,6,76.1,4,2
283,26,0,33,8,75.6,5,3
283,27,0,20,4,74.4,4,0
283,28,0,11,4,73.9,3,1
283,29,0,7,2,77.7,1,1
283,30,0,25,7,78.0,5,2
284,1,0,64,6,68.1,1,5
284,2,0,62,7,65.6,1,6
284,3,0,38,4,68.2,3,1
284,4,0,72,8,67.5,3,5
284,5,0,69,7,63.3,3,4
284,6,0,35,4,65.7,3,1
284,7,0,38,6,64.4,2,4
284,8,0,63,9,66.5,5,4
284,9,0,92,10,64.5,3,7
284,10,0,61,7,65.2,0,7
284,11,0,50,7,67.1,3,4
284,12,0,54,7,69.6,4,3
284,13,0,50,7,67.7,2,5
284,14,0,51,10,68.8,6,4
284,15,0,93,14,63.8,5,9
284,16,0,67,11,65.0,6,5
284,17,0,86,14,68.8,5,9
284,18,0,75,12,66.7,5,7
284,19,0,61,10,70.6,3,7
284,20,0,48,9,65.4,4,5
284,21,0,36,7,68.0,1,6
284,22,0,46,7,67.7,2,5
284,23,0,66,12,67.4,4,8
284,24,0,62,15,67.5,5,10
284,25,0,67,12,69.5,4,8
284,26,0,98,17,68.9,4,13
284,27,0,38,9,65.7,4,5
284,28,0,38,7,68.8,3,4
284,29,0,57,13,67.6,3,10
284,30,0,51,12,65.4,6,6
285,1,1,58,13,49.8,8,5
285,2,1,32,9,49.4,4,5
285,3,1,46,16,47.0,11,5
285,4,1,84,24,48.9,9,15
285,5,1,61,18,42.5,10,8
285,6,1,45,13,45.0,5,8
285,7,1,44,17,46.2,12,5
285,8,1,40,17,49.5,9,8
285,9,1,47,17,47.8,10,7
285,10,1,64,24,49.7,18,6
285,11,1,67,27,49.2,17,10
285,12,1,41,15,49.9,5,10
285,13,1,25,13,47.0,6,7
285,14,1,20,8,48.1,2,6
285,15,1,49,21,53.0,11,10
285,16,1,58,24,45.4,11,13
285,17,1,55,23,49.5,11,12
285,18,1,49,23,43.6,10,13
285,19,1,50,23,48.0,15,8
285,20,1,30,13,45.8,11,2
285,21,1,33,16,49.5,11,5
285,22,1,80,39,46.8,12,27
285,23,1,48,26,48.3,17,9
285,24,1,27,14,47.7,5,9
285,25,1,47,26,46.4,15,11
285,26,1,57,34,43.9,17,17
285,27,1,41,23,45.2,9,14
285,28,1,36,22,50.4,14,8
285,29,1,52,31,49.9,15,16
285,30,1,31,22,48.7,8,14
286,1,0,72,11,69.4,4,7
286,2,0,41,4,67.6,2,2
286,3,0,61,10,69.7,6,4
286,4,0,63,7,65.4,3,4
286,5,0,45,6,67.7,3,3
286,6,0,49,4,68.0,2,2
286,7,0,52,6,66.9,6,0
286,8,0,47,7,68.2,2,5
286,9,0,50,7,70.0,2,5
286,10,0,68,9,69.2,3,6
286,11,0,46,6,72.6,2,4
286,12,0,35,5,66.7,2,3
286,13,0,50,9,69.4,4,5
286,14,0,32,6,70.4,2,4
286,15,0,68,10,62.6,6,4
286,16,0,35,9,67.5,7,2
286,17,0,94,13,68.4,6,7
286,18,0,73,10,73.1,8,2
286,19,0,52,8,67.6,4,4
286,20,0,33,9,71.5,3,6
286,21,0,43,12,71.8,6,6
286,22,0,66,10,69.1,4,6
286,23,0,54,10,67.6,2,8
286,24,0,68,12,66.2,5,7
286,25,0,54,10,71.6,5,5
286,26,0,50,11,69.4,6,5
286,27,0,39,9,70.3,4,5
286,28,0,40,7,70.7,4,3
286,29,0,54,12,66.5,8,4
286,30,0,53,12,69.5,7,5
287,1,0,43,6,52.2,5,1
287,2,0,20,3,46.1,3,0
287,3,0,39,5,50.6,3,2
287,4,0,8,2,47.6,1,1
287,5,0,23,6,50.7,4,2
287,6,0,0,3,51.6,1,2
287,7,0,14,4,51.1,3,1
287,8,0,20,2,52.0,1,1
287,9,0,25,4,51.3,3,1
287,10,0,54,10,56.3,6,4
287,11,0,34,5,50.9,3,2
287,12,0,35,8,49.4,1,7
287,13,0,9,2,50.7,2,0
287,14,0,21,3,53.4,2,1
287,15,0,28,4,53.6,2,2
287,16,0,27,5,56.1,2,3
287,17,0,30,7,50.3,2,5
287,18,0,0,2,53.2,1,1
287,19,0,20,3,54.1,1,2
287,20,0,9,3,47.7,2,1
287,21,0,37,8,52.8,6,2
287,22,0,0,4,48.6,3,1
287,23,0,22,4,48.0,2,2
287,24,0,41,9,53.7,6,3
287,25,0,30,6,54.4,4,2
287,26,0,31,7,49.9,5,2
287,27,0,0,3,48.3,1,2
287,28,0,40,8,53.3,6,2
287,29,0,0,4,50.2,3,1
287,30,0,51,12,51.0,8,4
288,1,0,67,5,70.7,1,4
288,2,0,59,7,75.0,5,2
288,3,0,94,8,71.8,5,3
288,4,0,61,9,73.6,4,5
288,5,0,104,13,70.1,5,8
288,6,0,73,7,75.9,3,4
288,7,0,51,6,73.4,1,5
288,8,0,76,8,72.7,5,3
288,9,0,64,6,70.6,3,3
288,10,0,97,13,72.8,5,8
288,11,0,89,15,74.0,5,10
288,12,0,91,11,70.2,6,5
288,13,0,57,10,69.3,5,5
288,14,0,63,10,74.1,6,4
288,15,0,118,15,85.7,8,7
288,16,0,74,12,73.0,4,8
288,17,0,80,11,73.6,7,4
288,18,0,98,16,76.0,6,10
288,19,0,86,13,72.3,6,7
288,20,0,50,10,70.5,4,6
288,21,0,75,16,70.4,8,8
288,22,0,80,15,71.3,6,9
288,23,0,88,15,74.8,4,11
288,24,0,75,14,72.5,8,6
288,25,0,90,17,72.0,9,8
288,26,0,127,25,72.9,12,13
288,27,0,67,14,72.5,9,5
288,28,0,74,15,70.4,6,9
288,29,0,99,22,72.2,5,17
288,30,0,104,23,68.9,8,15
289,1,0,28,1,42.5,1,0
289,2,0,34,5,45.7,3,2
289,3,0,0,1,43.9,0,1
289,4,0,29,2,42.5,1,1
289,5,0,44,6,42.9,2,4
289,6,0,0,2,41.6,2,0
289,7,0,0,0,44.0,0,0
289,8,0,0,2,43.9,2,0
289,9,0,13,1,40.1,1,0
289,10,0,29,4,43.5,3,1
289,11,0,30,8,40.9,7,1
289,12,0,11,2,44.0,2,0
289,13,0,2,2,43.3,1,1
289,14,0,6,5,43.3,3,2
289,15,0,19,2,46.3,1,1
289,16,0,0,1,45.1,1,0
289,17,0,2,3,40.5,3,0
289,18,0,8,3,38.5,2,1
289,19,0,48,9,45.9,5,4
289,20,0,22,4,43.5,4,0
289,21,0,0,1,45.9,1,0
289,22,0,3,2,42.8,1,1
289,23,0,0,1,42.0,0,1
289,24,0,7,7,44.1,4,3
289,25,0,12,4,43.9,2,2
289,26,0,1,1,40.9,1,0
289,27,0,2,0,42.7,0,0
289,28,0,0,1,45.1,0,1
289,29,0,21,7,41.7,5,2
289,30,0,0,3,39.1,3,0
290,1,0,76,8,36.2,6,2
290,2,0,71,6,36.7,6,0
290,3,0,60,7,33.5,6,1
290,4,0,82,6,37.2,3,3
290,5,0,91,10,35.9,6,4
290,6,0,45,6,35.6,5,1
290,7,0,36,5,34.7,4,1
290,8,0,97,9,33.9,8,1
290,9,0,74,8,36.0,5,3
290,10,0,86,12,36.8,8,4
290,11,0,66,7,35.9,5,2
290,12,0,56,7,35.8,4,3
290,13,0,51,9,35.5,8,1
290,14,0,39,9,38.2,6,3
290,15,0,37,6,29.7,5,1
290,16,0,61,8,34.3,5,3
290,17,0,62,10,37.9,9,1
290,18,0,73,11,36.8,8,3
290,19,0,77,12,37.3,9,3
290,20,0,50,10,35.7,6,4
290,21,0,34,6,37.7,3,3
290,22,0,70,13,37.1,10,3
290,23,0,60,11,35.2,6,5
290,24,0,67,16,32.6,11,5
290,25,0,73,13,35.0,9,4
290,26,0,44,12,36.3,8,4
290,27,0,48,10,37.9,5,5
290,28,0,51,13,37.1,9,4
290,29,0,43,10,36.4,8,2
290,30,0,66,14,35.7,8,6
291,1,0,76,7,36.5,4,3
291,2,0,91,10,33.7,5,5
291,3,0,86,6,39.1,3,3
291,4,0,85,8,33.5,5,3
291,5,0,102,9,37.5,3,6
291,6,0,54,8,38.6,3,5
291,7,0,63,8,36.9,6,2
291,8,0,85,13,40.6,9,4
291,9,0,104,12,35.8,8,4
291,10,0,105,12,38.1,10,2
291,11,0,54,7,34.7,4,3
291,12,0,98,12,35.0,9,3
291,13,0,67,10,32.5,6,4
291,14,0,61,8,37.0,5,3
291,15,0,57,11,34.5,8,3
291,16,0,102,17,39.6,9,8
291,17,0,98,15,34.4,10,5
291,18,0,72,13,36.5,5,8
291,19,0,81,16,35.8,9,7
291,20,0,72,12,35.1,9,3
291,21,0,64,13,37.3,10,3
291,22,0,81,17,35.2,10,7
291,23,0,83,16,33.6,14,2
291,24,0,96,19,34.0,16,3
291,25,0,86,15,38.1,11,4
291,26,0,97,18,33.7,13,5
291,27,0,48,9,34.8,5,4
291,28,0,51,13,35.2,9,4
291,29,0,74,16,33.4,9,7
291,30,0,90,20,38.6,14,6
292,1,0,96,7,69.3,1,6
292,2,0,104,11,73.4,5,6
292,3,0,95,9,72.1,3,6
292,4,0,82,8,72.9,3,5
292,5,0,78,12,72.7,7,5
292,6,0,54,7,71.1,2,5
292,7,0,78,9,70.4,1,8
292,8,0,110,13,72.4,6,7
292,9,0,87,11,74.5,4,7
292,10,0,88,12,75.9,3,9
292,11,0,89,10,73.2,4,6
292,12,0,96,12,69.7,4,8
292,13,0,82,10,74.1,7,3
292,14,0,54,9,72.6,2,7
292,15,0,70,10,71.3,3,7
292,16,0,90,13,70.0,5,8
292,17,0,84,12,71.7,4,8
292,18,0,79,12,69.5,6,6
292,19,0,94,17,68.8,5,12
292,20,0,67,12,69.9,5,7
292,21,0,60,9,70.6,2,7
292,22,0,96,17,71.2,6,11
292,23,0,74,14,73.0,6,8
292,24,0,91,17,69.7,6,11
292,25,0,95,21,70.5,9,12
292,26,0,70,13,71.2,4,9
292,27,0,73,13,69.7,5,8
292,28,0,52,10,72.4,5,5
292,29,0,95,20,74.2,7,13
292,30,0,92,22,69.8,10,12
293,1,1,89,18,37.4,6,12
293,2,1,86,21,40.1,13,8
293,3,1,90,25,37.0,14,11
293,4,1,110,30,35.5,18,12
293,5,1,99,29,36.4,16,13
293,6,1,84,24,36.4,14,10
293,7,1,81,25,38.7,16,9
293,8,1,109,34,38.2,17,17
293,9,1,118,39,34.9,19,20
293,10,1,114,39,39.5,23,16
293,11,1,108,43,37.1,23,20
293,12,1,94,33,41.7,15,18
293,13,1,72,27,41.0,12,15
293,14,1,71,31,35.6,13,18
293,15,1,92,39,40.5,17,22
293,16,1,84,36,38.1,16,20
293,17,1,98,44,34.3,21,23
293,18,1,115,54,38.3,27,27
293,19,1,79,37,36.2,13,24
293,20,1,85,41,35.4,15,26
293,21,1,62,31,39.5,21,10
293,22,1,92,48,36.9,22,26
293,23,1,96,49,35.9,26,23
293,24,1,99,52,38.4,28,24
293,25,1,72,40,37.7,17,23
293,26,1,78,45,34.8,24,21
293,27,1,60,36,34.8,13,23
293,28,1,72,44,39.4,19,25
293,29,1,82,52,38.9,26,26
293,30,1,101,62,38.1,32,30
294,1,1,54,12,33.6,9,3
294,2,1,70,20,30.0,13,7
294,3,1,65,16,23.5,5,11
294,4,1,61,16,28.7,10,6
294,5,1,23,8,27.9,5,3
294,6,1,43,15,26.0,9,6
294,7,1,41,16,27.3,8,8
294,8,1,59,19,26.4,8,11
294,9,1,90,28,26.9,12,16
294,10,1,75,24,29.0,12,12
294,11,1,68,25,26.8,9,16
294,12,1,62,23,31.8,11,12
294,13,1,31,13,26.9,6,7
294,14,1,29,13,28.6,8,5
294,15,1,52,22,24.0,10,12
294,16,1,48,20,32.1,9,11
294,17,1,75,33,29.7,19,14
294,18,1,62,30,31.2,17,13
294,19,1,70,33,25.6,9,24
294,20,1,54,30,26.9,19,11
294,21,1,35,18,30.9,10,8
294,22,1,64,34,28.1,13,21
294,23,1,84,43,28.2,20,23
294,24,1,60,32,28.0,17,15
294,25,1,62,36,31.5,19,17
294,26,1,50,29,27.7,12,17
294,27,1,50,29,28.0,12,17
294,28,1,32,22,24.1,13,9
294,29,1,81,47,28.0,24,23
294,30,1,76,47,24.3,17,30
295,1,0,34,3,56.1,0,3
295,2,0,22,2,57.4,1,1
295,3,0,54,7,54.1,3,4
295,4,0,32,6,57.9,2,4
295,5,0,65,5,55.9,1,4
295,6,0,20,2,57.3,0,2
295,7,0,30,6,54.7,5,1
295,8,0,40,5,58.7,3,2
295,9,0,46,5,59.3,1,4
295,10,0,52,7,57.7,5,2
295,11,0,58,8,56.8,3,5
295,12,0,21,4,57.9,3,1
295,13,0,13,3,58.1,0,3
295,14,0,12,4,55.0,0,4
295,15,0,44,8,68.0,6,2
295,16,0,45,6,58.6,1,5
295,17,0,48,9,59.4,2,7
295,18,0,25,5,56.5,3,2
295,19,0,48,9,58.0,5,4
295,20,0,29,8,56.1,5,3
295,21,0,17,8,56.1,3,5
295,22,0,7,3,55.0,1,2
295,23,0,52,9,56.7,2,7
295,24,0,43,9,56.4,3,6
295,25,0,70,13,55.3,2,11
295,26,0,41,9,60.2,3,6
295,27,0,34,8,58.2,3,5
295,28,0,27,6,56.4,3,3
295,29,0,52,11,57.6,5,6
295,30,0,68,17,56.4,7,10
296,1,0,68,9,60.6,6,3
296,2,0,94,8,57.7,6,2
296,3,0,89,11,59.8,5,6
296,4,0,83,8,61.4,3,5
296,5,0,104,11,58.6,6,5
296,6,0,66,7,60.9,5,2
296,7,0,56,6,61.9,5,1
296,8,0,62,6,58.1,4,2
296,9,0,92,10,62.5,5,5
296,10,0,83,9,60.2,3,6
296,11,0,74,11,59.0,5,6
296,12,0,70,13,56.7,4,9
296,13,0,53,8,58.1,5,3
296,14,0,79,15,61.1,7,8
296,15,0,66,9,58.1,3,6
296,16,0,105,16,61.9,6,10
296,17,0,63,10,61.9,6,4
296,18,0,81,14,58.0,7,7
296,19,0,113,18,60.5,8,10
296,20,0,50,8,60.3,6,2
296,21,0,53,10,61.0,6,4
296,22,0,88,17,61.5,11,6
296,23,0,85,15,61.8,8,7
296,24,0,64,12,60.5,6,6
296,25,0,78,16,61.5,6,10
296,26,0,51,13,57.8,5,8
296,27,0,71,16,61.4,8,8
296,28,0,73,16,61.4,8,8
296,29,0,69,14,63.0,9,5
296,30,0,107,24,60.6,9,15
297,1,1,50,14,70.2,9,5
297,2,1,38,9,70.8,5,4
297,3,1,34,13,70.6,10,3
297,4,1,36,13,68.6,7,6
297,5,1,37,11,68.9,6,5
297,6,1,42,13,65.0,6,7
297,7,1,46,14,70.8,9,5
297,8,1,43,14,66.1,3,11
297,9,1,44,16,66.5,8,8
297,10,1,40,13,70.7,3,10
297,11,1,29,12,69.4,5,7
297,12,1,18,8,69.2,3,5
297,13,1,19,9,68.5,3,6
297,14,1,32,14,68.9,8,6
297,15,1,33,15,65.6,8,7
297,16,1,40,16,66.0,8,8
297,17,1,28,12,68.4,7,5
297,18,1,55,26,70.5,9,17
297,19,1,43,21,67.5,9,12
297,20,1,35,17,66.7,9,8
297,21,1,36,21,66.6,11,10
297,22,1,30,15,67.9,8,7
297,23,1,40,23,63.7,9,14
297,24,1,37,22,66.8,15,7
297,25,1,45,24,62.7,12,12
297,26,1,65,40,66.9,17,23
297,27,1,25,19,68.0,6,13
297,28,1,10,9,68.7,5,4
297,29,1,35,21,68.0,10,11
297,30,1,28,21,67.2,18,3
298,1,0,32,5,46.0,1,4
298,2,0,54,7,46.6,2,5
298,3,0,42,6,45.6,2,4
298,4,0,38,7,46.1,2,5
298,5,0,86,10,44.1,4,6
298,6,0,47,7,42.3,2,5
298,7,0,30,7,42.5,3,4
298,8,0,72,10,42.9,3,7
298,9,0,44,5,40.5,3,2
298,10,0,39,7,44.0,2,5
298,11,0,58,9,44.3,4,5
298,12,0,54,7,46.4,2,5
298,13,0,13,4,45.4,2,2
298,14,0,35,7,43.8,1,6
298,15,0,69,10,50.8,3,7
298,16,0,56,10,45.7,3,7
298,17,0,59,9,44.5,5,4
298,18,0,51,7,47.9,4,3
298,19,0,13,7,46.0,2,5
298,20,0,51,8,42.7,3,5
298,21,0,40,7,42.7,2,5
298,22,0,36,9,44.3,3,6
298,23,0,44,10,43.5,3,7
298,24,0,48,8,47.0,4,4
298,25,0,42,8,44.1,3,5
298,26,0,29,9,39.9,3,6
298,27,0,45,8,45.2,2,6
298,28,0,35,7,47.8,4,3
298,29,0,48,12,43.4,4,8
298,30,0,95,21,41.3,7,14
299,1,0,144,12,25.8,4,8
299,2,0,74,7,21.6,2,5
299,3,0,81,7,26.2,3,4
299,4,0,96,9,19.1,3,6
299,5,0,81,8,22.8,2,6
299,6,0,45,9,20.4,8,1
299,7,0,44,8,22.4,6,2
299,8,0,110,14,24.5,8,6
299,9,0,94,11,24.2,7,4
299,10,0,89,15,21.3,5,10
299,11,0,66,9,23.8,6,3
299,12,0,121,15,22.4,9,6
299,13,0,74,11,24.8,5,6
299,14,0,65,10,24.5,7,3
299,15,0,103,14,27.6,9,5
299,16,0,86,13,28.7,6,7
299,17,0,94,14,21.9,5,9
299,18,0,71,13,25.0,8,5
299,19,0,98,18,26.7,11,7
299,20,0,72,12,26.9,7,5
299,21,0,72,14,20.2,8,6
299,22,0,105,18,24.2,7,11
299,23,0,113,24,24.8,14,10
299,24,0,113,21,25.1,8,13
299,25,0,111,19,29.0,11,8
299,26,0,111,23,29.5,16,7
299,27,0,63,15,25.7,9,6
299,28,0,62,12,27.8,6,6
299,29,0,88,18,24.9,7,11
299,30,0,91,19,27.9,10,9
300,1,0,114,9,30.6,6,3
300,2,0,95,9,27.1,8,1
300,3,0,85,9,26.2,7,2
300,4,0,92,7,23.8,7,0
300,5,0,115,10,24.2,3,7
300,6,0,80,8,24.8,3,5
300,7,0,87,10,28.3,6,4
300,8,0,114,13,26.0,9,4
300,9,0,122,14,27.3,7,7
300,10,0,100,11,29.6,7,4
300,11,0,105,16,28.3,9,7
300,12,0,78,10,30.8,6,4
300,13,0,79,10,27.5,7,3
300,14,0,67,12,24.9,7,5
300,15,0,116,16,29.3,9,7
300,16,0,106,17,25.8,8,9
300,17,0,93,15,26.5,7,8
300,18,0,103,18,27.8,14,4
300,19,0,99,17,28.3,11,6
300,20,0,80,15,27.5,10,5
300,21,0,77,15,28.4,9,6
300,22,0,118,20,30.0,13,7
300,23,0,120,24,29.2,18,6
300,24,0,109,20,28.8,12,8
300,25,0,90,17,28.7,11,6
300,26,0,87,18,26.3,15,3
300,27,0,72,15,28.3,11,4
300,28,0,73,13,26.0,9,4
300,29,0,78,17,27.2,13,4
300,30,0,111,25,30.1,19,6
301,1,0,25,3,29.7,2,1
301,2,0,18,4,25.4,3,1
301,3,0,21,4,28.9,3,1
301,4,0,30,2,27.9,1,1
301,5,0,11,2,27.2,0,2
301,6,0,34,5,25.8,0,5
301,7,0,8,2,28.9,2,0
301,8,0,38,4,27.8,2,2
301,9,0,49,8,27.7,5,3
301,10,0,48,7,26.7,3,4
301,11,0,52,8,28.5,3,5
301,12,0,14,2,29.7,2,0
301,13,0,35,5,26.2,3,2
301,14,0,28,6,29.2,3,3
301,15,0,51,8,35.4,3,5
301,16,0,48,7,26.1,2,5
301,17,0,17,4,26.9,1,3
301,18,0,35,7,30.6,4,3
301,19,0,41,7,27.8,3,4
301,20,0,16,4,28.8,2,2
301,21,0,18,3,26.5,0,3
301,22,0,24,7,26.1,1,6
301,23,0,8,2,27.3,2,0
301,24,0,37,7,25.6,4,3
301,25,0,55,10,26.6,4,6
301,26,0,22,7,28.3,2,5
301,27,0,40,9,28.2,4,5
301,28,0,26,5,27.7,2,3
301,29,0,16,5,26.2,3,2
301,30,0,38,7,24.6,4,3
302,1,1,81,20,48.2,11,9
302,2,1,95,21,42.7,14,7
302,3,1,101,26,44.7,12,14
302,4,1,106,29,41.2,20,9
302,5,1,62,19,43.9,8,11
302,6,1,58,19,44.2,5,14
302,7,1,85,28,43.9,15,13
302,8,1,83,25,44.3,18,7
302,9,1,86,27,43.8,21,6
302,10,1,101,34,49.2,16,18
302,11,1,113,40,48.0,24,16
302,12,1,80,30,42.8,9,21
302,13,1,75,30,44.1,14,16
302,14,1,63,25,44.1,12,13
302,15,1,109,48,33.6,11,37
302,16,1,78,36,46.7,14,22
302,17,1,97,43,44.5,22,21
302,18,1,88,40,43.9,20,20
302,19,1,87,43,46.8,25,18
302,20,1,68,32,43.4,10,22
302,21,1,49,23,46.8,13,10
302,22,1,76,39,44.9,19,20
302,23,1,113,58,44.5,36,22
302,24,1,68,36,44.7,24,12
302,25,1,94,51,44.5,31,20
302,26,1,105,61,43.0,32,29
302,27,1,62,35,48.1,11,24
302,28,1,62,36,42.7,19,17
302,29,1,117,69,45.0,34,35
302,30,1,110,68,46.7,28,40
303,1,0,74,5,27.0,1,4
303,2,0,54,4,29.1,2,2
303,3,0,73,9,25.0,2,7
303,4,0,53,5,24.5,0,5
303,5,0,64,7,26.5,4,3
303,6,0,32,4,25.0,1,3
303,7,0,50,6,28.7,2,4
303,8,0,55,8,30.6,3,5
303,9,0,70,7,27.8,3,4
303,10,0,42,5,24.9,0,5
303,11,0,75,10,26.3,4,6
303,12,0,74,9,30.0,2,7
303,13,0,42,6,29.7,2,4
303,14,0,41,8,27.8,3,5
303,15,0,56,8,19.9,2,6
303,16,0,53,7,27.5,1,6
303,17,0,59,9,29.1,3,6
303,18,0,81,14,30.5,4,10
303,19,0,45,8,26.4,3,5
303,20,0,34,6,26.5,1,5
303,21,0,72,12,27.1,5,7
303,22,0,51,11,27.7,3,8
303,23,0,65,12,27.0,5,7
303,24,0,56,12,27.0,6,6
303,25,0,48,10,23.9,3,7
303,26,0,85,16,27.0,7,9
303,27,0,49,11,25.0,3,8
303,28,0,42,8,27.6,4,4
303,29,0,77,19,27.0,9,10
303,30,0,56,12,26.6,7,5
304,1,1,93,21,53.6,12,9
304,2,1,93,23,52.1,10,13
304,3,1,101,27,53.7,10,17
304,4,1,127,35,53.1,17,18
304,5,1,96,26,52.1,12,14
304,6,1,69,21,49.9,6,15
304,7,1,81,27,51.0,9,18
304,8,1,101,33,55.6,22,11
304,9,1,84,28,52.5,21,7
304,10,1,115,42,52.4,18,24
304,11,1,92,32,51.7,18,14
304,12,1,78,30,57.3,16,14
304,13,1,68,27,49.1,12,15
304,14,1,82,31,53.9,14,17
304,15,1,98,42,52.1,17,25
304,16,1,89,37,53.3,24,13
304,17,1,103,43,53.0,22,21
304,18,1,111,50,51.4,30,20
304,19,1,95,47,53.8,33,14
304,20,1,68,32,51.1,11,21
304,21,1,65,33,49.1,12,21
304,22,1,130,69,51.1,27,42
304,23,1,110,58,50.7,26,32
304,24,1,90,49,49.7,14,35
304,25,1,92,54,49.0,25,29
304,26,1,106,59,48.4,31,28
304,27,1,70,40,49.0,26,14
304,28,1,71,43,54.7,17,26
304,29,1,111,70,52.2,35,35
304,30,1,97,59,48.5,33,26
305,1,0,97,7,74.6,2,5
305,2,0,97,11,72.5,3,8
305,3,0,103,9,74.8,3,6
305,4,0,119,12,70.3,1,11
305,5,0,114,13,77.5,5,8
305,6,0,78,8,71.6,3,5
305,7,0,68,8,77.6,4,4
305,8,0,115,12,74.9,5,7
305,9,0,104,13,80.4,3,10
305,10,0,105,15,71.7,6,9
305,11,0,113,18,76.9,5,13
305,12,0,109,14,72.0,6,8
305,13,0,73,11,71.6,3,8
305,14,0,90,14,74.4,7,7
305,15,0,88,12,70.0,3,9
305,16,0,100,14,76.0,2,12
305,17,0,106,18,74.4,4,14
305,18,0,117,21,72.7,7,14
305,19,0,119,18,71.8,5,13
305,20,0,90,14,75.3,4,10
305,21,0,70,13,77.9,6,7
305,22,0,116,20,76.7,8,12
305,23,0,116,19,70.9,6,13
305,24,0,104,21,73.7,9,12
305,25,0,145,28,77.1,11,17
305,26,0,107,19,69.5,7,12
305,27,0,75,14,75.9,4,10
305,28,0,87,21,73.8,6,15
305,29,0,109,24,70.8,9,15
305,30,0,103,28,71.9,4,24
306,1,0,88,6,50.0,2,4
306,2,0,93,8,49.6,4,4
306,3,0,95,8,41.5,6,2
306,4,0,86,8,45.9,3,5
306,5,0,74,8,51.5,4,4
306,6,0,69,9,51.4,4,5
306,7,0,60,5,49.9,4,1
306,8,0,104,10,50.4,6,4
306,9,0,84,11,50.2,9,2
306,10,0,99,10,50.5,6,4
306,11,0,66,10,50.6,8,2
306,12,0,108,15,52.9,10,5
306,13,0,62,12,46.0,4,8
306,14,0,63,10,51.7,8,2
306,15,0,105,15,50.0,8,7
306,16,0,70,10,50.5,8,2
306,17,0,86,14,50.5,11,3
306,18,0,79,11,48.1,6,5
306,19,0,99,17,45.0,8,9
306,20,0,54,9,50.0,6,3
306,21,0,74,14,49.8,9,5
306,22,0,101,18,50.5,16,2
306,23,0,122,23,49.3,16,7
306,24,0,59,12,47.9,7,5
306,25,0,56,13,48.1,6,7
306,26,0,51,9,49.1,7,2
306,27,0,68,14,47.9,11,3
306,28,0,73,16,50.7,13,3
306,29,0,72,15,52.6,7,8
306,30,0,104,20,47.6,14,6
307,1,0,57,8,29.3,3,5
307,2,0,45,7,32.4,2,5
307,3,0,75,7,31.0,1,6
307,4,0,66,8,27.4,1,7
307,5,0,35,7,33.1,4,3
307,6,0,41,5,31.6,1,4
307,7,0,46,7,29.1,1,6
307,8,0,71,9,28.7,3,6
307,9,0,52,5,27.1,3,2
307,10,0,69,8,31.5,4,4
307,11,0,56,7,29.5,1,6
307,12,0,79,10,33.4,1,9
307,13,0,43,5,30.7,1,4
307,14,0,51,7,29.6,2,5
307,15,0,90,14,33.6,5,9
307,16,0,51,9,32.8,0,9
307,17,0,64,12,29.7,2,10
307,18,0,52,8,27.4,3,5
307,19,0,79,13,29.1,3,10
307,20,0,36,6,31.1,3,3
307,21,0,37,7,30.5,0,7
307,22,0,70,15,29.3,6,9
307,23,0,41,9,27.9,3,6
307,24,0,75,16,28.8,7,9
307,25,0,67,12,27.8,5,7
307,26,0,68,13,28.7,5,8
307,27,0,45,10,32.3,5,5
307,28,0,45,10,29.4,5,5
307,29,0,82,20,33.4,5,15
307,30,0,85,19,28.4,6,13
308,1,0,27,3,44.9,2,1
308,2,0,56,5,44.3,5,0
308,3,0,18,3,47.0,1,2
308,4,0,33,3,44.7,2,1
308,5,0,51,5,45.7,2,3
308,6,0,38,4,44.1,1,3
308,7,0,27,8,38.8,3,5
308,8,0,24,4,44.9,1,3
308,9,0,45,6,47.1,2,4
308,10,0,6,1,45.7,0,1
308,11,0,60,11,47.5,2,9
308,12,0,32,6,44.7,2,4
308,13,0,15,5,45.3,1,4
308,14,0,11,5,45.5,3,2
308,15,0,39,7,40.3,3,4
308,16,0,45,8,49.3,2,6
308,17,0,37,6,45.7,4,2
308,18,0,45,8,44.0,3,5
308,19,0,25,5,39.8,2,3
308,20,0,17,4,46.5,1,3
308,21,0,28,5,41.6,1,4
308,22,0,42,7,42.8,4,3
308,23,0,25,6,47.1,4,2
308,24,0,35,6,44.9,3,3
308,25,0,18,6,45.1,4,2
308,26,0,23,6,48.5,1,5
308,27,0,19,5,42.6,2,3
308,28,0,24,6,44.0,2,4
308,29,0,33,7,44.2,2,5
308,30,0,22,4,43.2,0,4
309,1,1,55,11,74.3,4,7
309,2,1,52,13,73.0,3,10
309,3,1,41,11,71.0,9,2
309,4,1,32,9,72.6,6,3
309,5,1,38,10,70.5,5,5
309,6,1,26,8,68.5,7,1
309,7,1,33,14,70.1,8,6
309,8,1,36,13,70.7,9,4
309,9,1,61,22,70.4,10,12
309,10,1,38,14,70.5,6,8
309,11,1,45,15,72.1,8,7
309,12,1,21,9,74.2,6,3
309,13,1,39,16,74.2,9,7
309,14,1,37,18,69.7,7,11
309,15,1,38,16,74.2,10,6
309,16,1,56,25,71.3,12,13
309,17,1,35,15,70.6,5,10
309,18,1,16,13,72.3,3,10
309,19,1,20,11,69.1,4,7
309,20,1,23,11,72.0,4,7
309,21,1,46,24,70.8,10,14
309,22,1,47,26,70.8,14,12
309,23,1,34,21,70.0,7,14
309,24,1,2,3,74.0,0,3
309,25,1,27,17,69.1,9,8
309,26,1,32,19,68.4,8,11
309,27,1,29,18,73.6,10,8
309,28,1,25,16,68.2,7,9
309,29,1,32,21,71.9,13,8
309,30,1,28,16,68.6,6,10
310,1,1,13,3,21.9,2,1
310,2,1,0,3,19.2,2,1
310,3,1,11,5,20.3,3,2
310,4,1,18,5,23.5,1,4
310,5,1,4,2,22.1,1,1
310,6,1,22,10,21.7,3,7
310,7,1,9,5,15.6,4,1
310,8,1,24,10,18.5,3,7
310,9,1,33,11,21.5,8,3
310,10,1,0,1,16.6,0,1
310,11,1,0,6,21.2,4,2
310,12,1,13,5,21.0,2,3
310,13,1,0,2,21.4,0,2
310,14,1,2,3,22.4,2,1
310,15,1,11,7,16.8,2,5
310,16,1,0,1,22.0,0,1
310,17,1,0,2,20.6,2,0
310,18,1,35,16,20.1,8,8
310,19,1,2,1,21.1,1,0
310,20,1,12,9,20.5,4,5
310,21,1,22,13,19.7,5,8
310,22,1,18,9,18.5,4,5
310,23,1,21,10,22.0,5,5
310,24,1,16,9,19.4,3,6
310,25,1,7,5,20.4,3,2
310,26,1,14,7,22.2,1,6
310,27,1,0,5,18.6,3,2
310,28,1,11,6,20.6,4,2
310,29,1,20,14,18.3,10,4
310,30,1,18,14,20.6,6,8
311,1,0,67,7,70.6,1,6
311,2,0,36,3,70.1,1,2
311,3,0,50,7,73.5,2,5
311,4,0,80,10,72.9,5,5
311,5,0,65,7,69.3,1,6
311,6,0,42,5,74.9,3,2
311,7,0,46,5,69.1,2,3
311,8,0,67,7,71.1,2,5
311,9,0,55,6,73.9,4,2
311,10,0,49,6,70.5,1,5
311,11,0,52,9,69.3,2,7
311,12,0,54,6,71.6,0,6
311,13,0,40,6,72.2,1,5
311,14,0,37,4,73.0,1,3
311,15,0,42,7,62.0,3,4
311,16,0,48,8,73.7,4,4
311,17,0,64,10,74.8,5,5
311,18,0,40,8,73.5,1,7
311,19,0,49,10,70.7,4,6
311,20,0,37,6,71.6,2,4
311,21,0,54,9,71.7,5,4
311,22,0,87,15,72.8,2,13
311,23,0,79,14,68.6,8,6
311,24,0,77,14,72.6,4,10
311,25,0,70,13,71.5,5,8
311,26,0,61,11,66.3,5,6
311,27,0,39,9,71.4,1,8
311,28,0,49,11,72.2,6,5
311,29,0,74,17,69.6,7,10
311,30,0,74,16,72.1,4,12
312,1,1,38,8,19.9,3,5
312,2,1,35,8,22.3,3,5
312,3,1,25,6,23.0,3,3
312,4,1,32,10,20.7,4,6
312,5,1,14,3,23.2,3,0
312,6,1,16,6,20.5,4,2
312,7,1,26,8,21.5,6,2
312,8,1,23,10,19.1,8,2
312,9,1,7,4,23.3,2,2
312,10,1,24,14,23.2,5,9
312,11,1,32,11,23.5,7,4
312,12,1,23,8,19.9,6,2
312,13,1,12,5,24.2,4,1
312,14,1,1,1,23.5,0,1
312,15,1,0,2,24.0,1,1
312,16,1,12,4,25.6,3,1
312,17,1,0,2,20.2,2,0
312,18,1,13,6,23.6,1,5
312,19,1,26,13,20.2,7,6
312,20,1,12,7,23.5,5,2
312,21,1,0,1,22.0,1,0
312,22,1,14,7,23.2,4,3
312,23,1,0,0,24.7,0,0
312,24,1,14,8,19.6,3,5
312,25,1,37,21,23.0,11,10
312,26,1,17,10,20.9,7,3
312,27,1,7,6,20.4,5,1
312,28,1,27,15,23.6,11,4
312,29,1,26,17,21.2,11,6
312,30,1,20,15,21.7,8,7
313,1,0,41,5,32.8,2,3
313,2,0,77,6,37.5,4,2
313,3,0,84,6,34.9,3,3
313,4,0,45,3,34.7,1,2
313,5,0,82,9,35.0,5,4
313,6,0,38,6,35.2,6,0
313,7,0,48,6,34.5,5,1
313,8,0,53,9,34.5,7,2
313,9,0,73,7,32.9,2,5
313,10,0,46,6,32.6,4,2
313,11,0,62,11,32.6,7,4
313,12,0,95,13,35.3,9,4
313,13,0,30,3,35.8,1,2
313,14,0,52,10,31.9,6,4
313,15,0,92,15,40.1,7,8
313,16,0,76,13,33.9,8,5
313,17,0,63,10,32.7,5,5
313,18,0,81,15,35.2,11,4
313,19,0,70,11,33.0,5,6
313,20,0,34,8,35.7,5,3
313,21,0,38,9,32.5,6,3
313,22,0,51,8,33.2,4,4
313,23,0,70,13,34.3,7,6
313,24,0,74,15,30.9,7,8
313,25,0,50,9,36.5,8,1
313,26,0,84,17,36.4,9,8
313,27,0,44,8,32.4,8,0
313,28,0,44,10,30.3,5,5
313,29,0,82,17,34.4,13,4
313,30,0,49,13,29.9,12,1
314,1,1,75,20,28.6,11,9
314,2,1,40,12,26.6,5,7
314,3,1,65,17,26.5,11,6
314,4,1,66,17,22.6,10,7
314,5,1,57,18,26.1,12,6
314,6,1,49,14,25.9,6,8
314,7,1,42,13,26.7,4,9
314,8,1,45,16,26.6,6,10
314,9,1,54,18,27.8,8,10
314,10,1,75,26,30.2,16,10
314,11,1,81,28,25.3,14,14
314,12,1,72,25,26.0,16,9
314,13,1,49,22,27.6,10,12
314,14,1,54,21,26.3,10,11
314,15,1,54,22,31.3,10,12
314,16,1,52,22,26.9,9,13
314,17,1,47,21,24.6,4,17
314,18,1,73,34,24.1,18,16
314,19,1,83,38,25.3,21,17
314,20,1,39,19,29.5,9,10
314,21,1,42,20,28.5,7,13
314,22,1,58,31,24.4,20,11
314,23,1,54,27,28.5,17,10
314,24,1,70,37,25.3,23,14
314,25,1,57,31,28.0,18,13
314,26,1,79,45,21.0,26,19
314,27,1,42,25,25.5,14,11
314,28,1,40,23,24.3,11,12
314,29,1,58,35,26.0,23,12
314,30,1,45,29,29.9,16,13
315,1,0,11,2,62.3,2,0
315,2,0,35,5,62.2,4,1
315,3,0,9,5,59.1,4,1
315,4,0,44,3,58.3,2,1
315,5,0,21,3,65.0,2,1
315,6,0,27,3,60.4,3,0
315,7,0,7,1,62.3,0,1
315,8,0,19,5,62.2,3,2
315,9,0,27,4,57.0,3,1
315,10,0,33,7,60.7,6,1
315,11,0,36,6,61.2,5,1
315,12,0,25,5,60.9,5,0
315,13,0,7,2,59.6,0,2
315,14,0,27,4,58.3,3,1
315,15,0,36,5,55.2,4,1
315,16,0,30,4,58.1,3,1
315,17,0,13,5,58.2,1,4
315,18,0,45,7,61.7,5,2
315,19,0,41,13,61.5,10,3
315,20,0,17,5,63.5,5,0
315,21,0,14,3,57.9,2,1
315,22,0,27,4,59.4,2,2
315,23,0,42,11,60.4,8,3
315,24,0,54,12,60.2,8,4
315,25,0,37,7,55.5,5,2
315,26,0,42,9,59.5,9,0
315,27,0,29,8,59.6,3,5
315,28,0,18,3,58.5,2,1
315,29,0,84,17,61.0,10,7
315,30,0,59,15,61.0,9,6
316,1,0,31,6,72.0,3,3
316,2,0,3,3,74.2,0,3
316,3,0,23,4,75.3,1,3
316,4,0,55,4,73.9,0,4
316,5,0,0,3,74.7,1,2
316,6,0,26,4,74.4,1,3
316,7,0,21,3,74.6,1,2
316,8,0,24,5,76.0,1,4
316,9,0,44,8,76.9,5,3
316,10,0,29,6,77.0,2,4
316,11,0,20,4,76.4,1,3
316,12,0,25,4,74.3,2,2
316,13,0,21,3,75.7,1,2
316,14,0,11,1,75.9,0,1
316,15,0,29,6,75.5,0,6
316,16,0,29,5,76.7,2,3
316,17,0,32,5,74.8,3,2
316,18,0,5,2,72.7,1,1
316,19,0,47,8,80.2,4,4
316,20,0,2,4,78.1,3,1
316,21,0,29,9,72.8,3,6
316,22,0,28,8,74.6,3,5
316,23,0,14,2,77.8,1,1
316,24,0,35,7,73.4,2,5
316,25,0,34,6,74.3,1,5
316,26,0,17,6,75.1,4,2
316,27,0,7,6,73.3,2,4
316,28,0,6,6,74.7,2,4
316,29,0,19,7,72.5,3,4
316,30,0,33,6,72.5,1,5
317,1,1,69,17,50.2,9,8
317,2,1,41,13,50.3,5,8
317,3,1,46,11,49.4,7,4
317,4,1,72,22,51.4,14,8
317,5,1,69,24,55.1,14,10
317,6,1,35,12,51.3,6,6
317,7,1,25,10,51.2,6,4
317,8,1,50,16,53.0,3,13
317,9,1,48,18,57.2,11,7
317,10,1,15,6,50.2,1,5
317,11,1,32,14,55.0,9,5
317,12,1,40,17,47.8,6,11
317,13,1,24,10,48.9,6,4
317,14,1,16,8,51.4,7,1
317,15,1,23,11,44.1,5,6
317,16,1,66,31,49.7,16,15
317,17,1,78,34,53.9,12,22
317,18,1,32,19,54.0,11,8
317,19,1,33,16,53.4,12,4
317,20,1,38,18,53.1,14,4
317,21,1,17,10,46.2,5,5
317,22,1,81,41,53.0,16,25
317,23,1,46,25,50.8,20,5
317,24,1,42,25,55.6,10,15
317,25,1,33,19,52.2,6,13
317,26,1,55,30,52.3,10,20
317,27,1,27,19,55.0,12,7
317,28,1,40,25,55.2,9,16
317,29,1,50,30,54.0,20,10
317,30,1,37,22,49.9,10,12
318,1,1,50,12,40.1,8,4
318,2,1,49,11,37.7,7,4
318,3,1,22,8,34.0,4,4
318,4,1,54,13,37.0,5,8
318,5,1,52,16,39.1,11,5
318,6,1,16,5,37.1,0,5
318,7,1,11,5,34.6,2,3
318,8,1,29,9,37.8,5,4
318,9,1,9,3,39.7,1,2
318,10,1,38,15,39.5,9,6
318,11,1,26,10,37.4,8,2
318,12,1,26,9,39.0,3,6
318,13,1,29,12,40.7,6,6
318,14,1,38,16,41.0,6,10
318,15,1,45,20,46.5,8,12
318,16,1,48,21,38.4,12,9
318,17,1,51,22,38.6,4,18
318,18,1,43,18,37.6,9,9
318,19,1,38,19,38.2,12,7
318,20,1,30,14,39.6,8,6
318,21,1,35,18,37.4,11,7
318,22,1,33,20,34.7,9,11
318,23,1,29,17,38.3,8,9
318,24,1,33,19,36.7,9,10
318,25,1,51,30,35.9,15,15
318,26,1,27,15,37.9,7,8
318,27,1,36,21,37.0,9,12
318,28,1,33,20,39.5,11,9
318,29,1,53,34,35.4,17,17
318,30,1,34,24,38.2,10,14
319,1,0,93,7,30.5,6,1
319,2,0,61,7,30.2,6,1
319,3,0,79,11,28.8,7,4
319,4,0,85,8,30.9,6,2
319,5,0,78,8,27.9,3,5
319,6,0,49,6,24.1,1,5
319,7,0,65,9,30.5,8,1
319,8,0,84,8,24.7,6,2
319,9,0,58,8,28.0,3,5
319,10,0,85,12,25.2,3,9
319,11,0,69,8,27.0,3,5
319,12,0,70,9,29.4,2,7
319,13,0,45,8,32.0,3,5
319,14,0,55,8,26.5,5,3
319,15,0,90,14,24.8,7,7
319,16,0,79,13,25.4,9,4
319,17,0,106,16,29.3,5,11
319,18,0,83,14,28.5,8,6
319,19,0,86,13,26.5,7,6
319,20,0,72,14,31.9,9,5
319,21,0,61,14,25.6,5,9
319,22,0,75,16,31.0,11,5
319,23,0,111,21,27.1,12,9
319,24,0,70,13,29.6,5,8
319,25,0,61,10,27.0,6,4
319,26,0,99,21,29.2,9,12
319,27,0,47,9,30.2,4,5
319,28,0,39,7,27.0,2,5
319,29,0,93,21,23.8,12,9
319,30,0,93,19,28.3,10,9
320,1,1,85,21,43.0,5,16
320,2,1,67,15,47.2,7,8
320,3,1,103,25,42.5,17,8
320,4,1,98,26,40.2,9,17
320,5,1,107,31,41.9,13,18
320,6,1,68,21,43.9,13,8
320,7,1,47,15,45.6,10,5
320,8,1,91,29,45.1,8,21
320,9,1,60,21,45.6,6,15
320,10,1,93,31,42.2,12,19
320,11,1,89,33,44.7,17,16
320,12,1,64,26,44.3,15,11
320,13,1,57,22,43.5,14,8
320,14,1,74,30,43.9,22,8
320,15,1,78,34,51.6,22,12
320,16,1,108,47,44.9,26,21
320,17,1,96,43,40.3,24,19
320,18,1,85,40,44.9,22,18
320,19,1,75,34,41.5,21,13
320,20,1,79,37,42.6,16,21
320,21,1,76,37,44.8,22,15
320,22,1,94,47,45.1,14,33
320,23,1,117,63,42.9,35,28
320,24,1,56,32,45.5,14,18
320,25,1,96,53,45.1,33,20
320,26,1,106,58,41.6,20,38
320,27,1,63,35,43.9,17,18
320,28,1,57,33,42.8,14,19
320,29,1,39,23,40.4,10,13
320,30,1,101,61,43.5,26,35
321,1,0,29,4,39.5,3,1
321,2,0,17,4,36.2,3,1
321,3,0,26,3,39.3,2,1
321,4,0,36,5,37.3,2,3
321,5,0,45,7,36.5,2,5
321,6,0,20,4,35.3,2,2
321,7,0,32,5,36.8,4,1
321,8,0,13,1,36.9,1,0
321,9,0,37,5,38.9,3,2
321,10,0,53,6,38.2,4,2
321,11,0,46,5,36.9,4,1
321,12,0,24,7,40.1,4,3
321,13,0,47,5,35.6,4,1
321,14,0,21,6,35.1,6,0
321,15,0,36,8,41.2,5,3
321,16,0,40,6,38.2,5,1
321,17,0,40,5,39.8,3,2
321,18,0,18,4,38.5,4,0
321,19,0,2,2,36.8,2,0
321,20,0,31,4,40.9,3,1
321,21,0,37,7,37.0,3,4
321,22,0,55,10,39.5,7,3
321,23,0,26,6,34.6,5,1
321,24,0,41,7,38.2,3,4
321,25,0,52,10,37.0,8,2
321,26,0,43,8,35.3,5,3
321,27,0,29,5,37.0,4,1
321,28,0,27,7,34.9,4,3
321,29,0,15,2,35.1,0,2
321,30,0,31,8,40.7,6,2
322,1,0,14,1,62.2,1,0
322,2,0,6,1,63.4,1,0
322,3,0,3,4,61.8,2,2
322,4,0,12,5,66.4,4,1
322,5,0,17,6,60.0,5,1
322,6,0,15,2,59.4,1,1
322,7,0,18,3,66.2,3,0
322,8,0,36,4,61.2,2,2
322,9,0,36,5,60.4,2,3
322,10,0,16,2,64.2,2,0
322,11,0,0,0,64.6,0,0
322,12,0,26,4,66.7,2,2
322,13,0,3,2,66.5,1,1
322,14,0,0,1,61.5,1,0
322,15,0,30,7,57.1,3,4
322,16,0,6,1,63.3,1,0
322,17,0,17,2,61.8,2,0
322,18,0,14,3,63.9,1,2
322,19,0,19,2,64.9,0,2
322,20,0,12,3,64.2,3,0
322,21,0,0,3,59.4,1,2
322,22,0,31,8,64.7,7,1
322,23,0,29,5,60.4,3,2
322,24,0,0,3,63.7,1,2
322,25,0,0,1,63.1,0,1
322,26,0,9,3,62.4,2,1
322,27,0,0,3,62.3,3,0
322,28,0,12,4,65.1,3,1
322,29,0,0,3,64.4,0,3
322,30,0,0,2,60.9,1,1
323,1,0,133,11,43.8,5,6
323,2,0,112,11,41.2,4,7
323,3,0,127,13,39.4,3,10
323,4,0,115,10,45.6,5,5
323,5,0,95,9,40.5,1,8
323,6,0,87,10,44.2,5,5
323,7,0,90,9,44.2,4,5
323,8,0,107,12,42.6,1,11
323,9,0,99,11,44.6,3,8
323,10,0,121,14,44.8,2,12
323,11,0,132,17,43.0,4,13
323,12,0,135,17,42.5,7,10
323,13,0,80,10,43.9,2,8
323,14,0,75,9,42.2,4,5
323,15,0,130,17,36.2,4,13
323,16,0,108,15,44.3,6,9
323,17,0,106,18,40.9,3,15
323,18,0,103,18,43.0,7,11
323,19,0,103,18,43.8,4,14
323,20,0,90,13,46.2,6,7
323,21,0,73,13,40.6,4,9
323,22,0,122,21,41.9,5,16
323,23,0,114,23,43.9,8,15
323,24,0,96,19,43.7,12,7
323,25,0,105,19,42.5,5,14
323,26,0,112,21,44.3,3,18
323,27,0,96,20,44.8,8,12
323,28,0,76,16,44.5,7,9
323,29,0,98,21,43.0,13,8
323,30,0,119,28,43.1,12,16
324,1,1,11,4,78.2,3,1
324,2,1,0,1,79.4,0,1
324,3,1,25,7,82.1,6,1
324,4,1,19,6,79.9,4,2
324,5,1,22,9,76.6,6,3
324,6,1,12,7,76.6,5,2
324,7,1,8,4,76.2,3,1
324,8,1,5,1,74.5,1,0
324,9,1,49,16,73.9,8,8
324,10,1,18,9,78.1,5,4
324,11,1,13,7,76.5,4,3
324,12,1,0,3,81.6,1,2
324,13,1,6,4,77.1,4,0
324,14,1,0,2,81.6,2,0
324,15,1,10,6,80.7,4,2
324,16,1,10,8,79.6,4,4
324,17,1,13,7,76.1,3,4
324,18,1,0,1,77.7,1,0
324,19,1,16,7,79.9,5,2
324,20,1,0,5,77.7,2,3
324,21,1,14,6,75.4,2,4
324,22,1,5,2,75.8,2,0
324,23,1,0,4,78.5,1,3
324,24,1,0,2,76.0,1,1
324,25,1,21,12,77.7,7,5
324,26,1,29,18,78.5,10,8
324,27,1,15,10,79.7,3,7
324,28,1,18,12,78.8,5,7
324,29,1,0,5,77.0,1,4
324,30,1,0,1,80.6,1,0
325,1,0,126,16,61.5,5,11
325,2,0,116,9,64.6,1,8
325,3,0,129,10,60.2,5,5
325,4,0,131,13,64.8,4,9
325,5,0,115,13,63.0,4,9
325,6,0,62,8,58.9,2,6
325,7,0,64,7,64.9,2,5
325,8,0,106,11,61.0,5,6
325,9,0,123,15,62.8,7,8
325,10,0,135,17,60.7,9,8
325,11,0,124,16,61.9,8,8
325,12,0,143,22,65.5,6,16
325,13,0,96,12,60.1,1,11
325,14,0,79,13,61.3,3,10
325,15,0,127,23,55.2,10,13
325,16,0,120,18,63.8,8,10
325,17,0,125,18,60.3,6,12
325,18,0,116,21,58.4,7,14
325,19,0,126,20,62.9,11,9
325,20,0,81,14,66.1,6,8
325,21,0,88,19,60.8,4,15
325,22,0,88,17,64.5,7,10
325,23,0,82,13,60.4,5,8
325,24,0,97,20,61.6,13,7
325,25,0,125,24,61.6,8,16
325,26,0,136,28,62.5,13,15
325,27,0,72,16,58.1,6,10
325,28,0,90,17,60.9,6,11
325,29,0,115,23,63.9,14,9
325,30,0,131,30,62.0,11,19
326,1,0,59,6,36.2,2,4
326,2,0,62,5,31.6,2,3
326,3,0,27,4,34.9,1,3
326,4,0,50,5,33.9,0,5
326,5,0,59,6,33.6,2,4
326,6,0,16,2,33.4,1,1
326,7,0,50,6,33.9,2,4
326,8,0,56,5,37.7,1,4
326,9,0,40,7,35.5,5,2
326,10,0,72,7,38.4,2,5
326,11,0,40,6,35.3,2,4
326,12,0,46,9,37.8,4,5
326,13,0,50,6,34.5,2,4
326,14,0,26,8,36.7,3,5
326,15,0,37,7,34.3,4,3
326,16,0,44,10,32.6,1,9
326,17,0,57,11,34.8,4,7
326,18,0,10,1,33.6,0,1
326,19,0,50,8,36.2,3,5
326,20,0,19,3,36.0,2,1
326,21,0,19,3,35.9,3,0
326,22,0,71,12,39.4,3,9
326,23,0,45,10,35.4,2,8
326,24,0,28,6,34.6,3,3
326,25,0,45,9,29.7,1,8
326,26,0,51,9,38.2,3,6
326,27,0,9,5,34.8,2,3
326,28,0,15,3,36.8,0,3
326,29,0,39,8,31.9,0,8
326,30,0,30,10,38.3,3,7
327,1,1,52,12,18.7,8,4
327,2,1,56,15,24.2,12,3
327,3,1,69,17,24.7,14,3
327,4,1,27,7,20.8,4,3
327,5,1,40,12,22.6,4,8
327,6,1,35,10,24.5,7,3
327,7,1,47,14,22.9,6,8
327,8,1,57,19,24.3,10,9
327,9,1,40,13,19.1,5,8
327,10,1,51,18,21.9,8,10
327,11,1,45,18,22.1,11,7
327,12,1,45,18,23.9,11,7
327,13,1,31,12,22.4,5,7
327,14,1,38,16,23.3,11,5
327,15,1,57,23,19.8,12,11
327,16,1,67,28,22.0,15,13
327,17,1,59,26,24.8,10,16
327,18,1,23,13,21.0,6,7
327,19,1,47,23,20.3,10,13
327,20,1,28,16,23.3,7,9
327,21,1,25,15,23.6,10,5
327,22,1,31,17,24.0,11,6
327,23,1,55,30,23.4,21,9
327,24,1,60,33,21.4,14,19
327,25,1,66,37,20.7,17,20
327,26,1,30,19,21.8,6,13
327,27,1,27,18,21.0,10,8
327,28,1,19,13,24.4,8,5
327,29,1,47,31,23.6,14,17
327,30,1,43,28,21.0,11,17
328,1,0,62,5,57.9,1,4
328,2,0,43,5,55.7,2,3
328,3,0,45,6,56.0,2,4
328,4,0,57,9,57.4,7,2
328,5,0,40,5,57.7,3,2
328,6,0,25,3,58.0,2,1
328,7,0,29,4,57.8,0,4
328,8,0,14,3,57.0,1,2
328,9,0,27,4,55.3,4,0
328,10,0,55,6,54.8,1,5
328,11,0,81,10,55.2,7,3
328,12,0,33,6,56.2,4,2
328,13,0,35,6,54.6,4,2
328,14,0,55,10,57.6,7,3
328,15,0,32,5,54.6,3,2
328,16,0,60,9,57.2,4,5
328,17,0,35,6,57.6,3,3
328,18,0,65,14,56.8,7,7
328,19,0,29,5,56.7,0,5
328,20,0,37,6,55.6,4,2
328,21,0,34,6,59.2,2,4
328,22,0,66,10,53.9,2,8
328,23,0,54,11,56.7,7,4
328,24,0,49,11,58.6,6,5
328,25,0,72,15,52.5,9,6
328,26,0,48,9,55.6,3,6
328,27,0,0,1,55.9,1,0
328,28,0,38,10,61.2,4,6
328,29,0,71,14,57.9,7,7
328,30,0,60,13,59.8,8,5
329,1,0,81,10,76.9,3,7
329,2,0,62,11,78.5,3,8
329,3,0,84,8,74.8,4,4
329,4,0,75,8,77.1,3,5
329,5,0,54,6,75.5,2,4
329,6,0,50,6,78.8,4,2
329,7,0,55,8,77.2,2,6
329,8,0,63,7,76.5,2,5
329,9,0,68,12,77.2,4,8
329,10,0,37,5,77.6,1,4
329,11,0,79,9,74.0,2,7
329,12,0,55,7,78.1,2,5
329,13,0,29,6,78.3,2,4
329,14,0,20,4,76.4,0,4
329,15,0,71,10,73.1,4,6
329,16,0,70,13,78.3,3,10
329,17,0,68,9,77.4,3,6
329,18,0,61,10,77.6,6,4
329,19,0,62,13,77.7,5,8
329,20,0,47,8,78.1,0,8
329,21,0,47,8,76.3,6,2
329,22,0,64,10,77.7,3,7
329,23,0,76,15,75.7,5,10
329,24,0,65,13,77.4,6,7
329,25,0,57,11,76.1,2,9
329,26,0,64,16,79.8,4,12
329,27,0,30,7,78.6,4,3
329,28,0,45,10,78.0,1,9
329,29,0,81,17,77.2,9,8
329,30,0,55,12,78.6,4,8
330,1,0,70,8,36.1,2,6
330,2,0,78,6,33.7,4,2
330,3,0,114,10,36.1,4,6
330,4,0,79,9,38.0,6,3
330,5,0,81,9,35.4,4,5
330,6,0,64,8,35.5,2,6
330,7,0,55,7,39.3,4,3
330,8,0,47,8,38.0,4,4
330,9,0,85,11,38.2,8,3
330,10,0,74,10,38.1,8,2
330,11,0,76,10,37.4,5,5
330,12,0,51,10,34.6,4,6
330,13,0,40,7,34.1,2,5
330,14,0,58,7,33.7,2,5
330,15,0,75,12,31.7,6,6
330,16,0,67,11,35.7,6,5
330,17,0,81,11,37.4,6,5
330,18,0,74,11,37.3,5,6
330,19,0,107,17,36.7,10,7
330,20,0,54,10,39.9,7,3
330,21,0,70,13,34.9,6,7
330,22,0,79,16,36.1,8,8
330,23,0,51,11,36.2,3,8
330,24,0,53,10,37.4,8,2
330,25,0,55,11,34.4,3,8
330,26,0,54,10,34.4,6,4
330,27,0,54,11,34.1,9,2
330,28,0,67,14,39.8,7,7
330,29,0,69,15,36.1,5,10
330,30,0,98,20,36.2,9,11
331,1,0,53,6,59.0,1,5
331,2,0,68,7,63.3,3,4
331,3,0,80,9,59.4,6,3
331,4,0,74,8,57.0,6,2
331,5,0,70,9,57.0,3,6
331,6,0,43,4,61.9,3,1
331,7,0,49,5,58.2,3,2
331,8,0,86,11,52.8,6,5
331,9,0,94,11,56.7,7,4
331,10,0,58,10,55.6,5,5
331,11,0,87,14,60.1,7,7
331,12,0,76,11,56.2,7,4
331,13,0,25,6,55.6,2,4
331,14,0,71,15,58.2,5,10
331,15,0,64,13,63.5,10,3
331,16,0,69,13,57.1,9,4
331,17,0,81,13,57.7,8,5
331,18,0,86,14,55.3,7,7
331,19,0,88,14,56.0,9,5
331,20,0,54,11,58.2,6,5
331,21,0,72,15,57.8,6,9
331,22,0,81,13,60.5,7,6
331,23,0,63,10,54.4,4,6
331,24,0,72,15,56.9,7,8
331,25,0,104,19,59.4,13,6
331,26,0,74,15,56.2,7,8
331,27,0,60,13,59.5,3,10
331,28,0,43,14,58.1,8,6
331,29,0,77,15,57.2,8,7
331,30,0,61,13,56.1,7,6
332,1,0,50,7,79.1,7,0
332,2,0,40,8,75.5,4,4
332,3,0,53,6,75.4,5,1
332,4,0,79,8,81.1,7,1
332,5,0,60,8,78.9,5,3
332,6,0,52,4,77.6,1,3
332,7,0,53,5,78.7,5,0
332,8,0,88,12,79.3,7,5
332,9,0,51,8,80.3,7,1
332,10,0,40,7,74.7,5,2
332,11,0,66,10,74.5,7,3
332,12,0,62,7,77.3,6,1
332,13,0,60,9,77.2,7,2
332,14,0,59,7,76.5,5,2
332,15,0,102,13,72.3,9,4
332,16,0,61,10,75.5,4,6
332,17,0,89,17,77.0,12,5
332,18,0,55,9,76.2,5,4
332,19,0,58,10,80.5,7,3
332,20,0,13,4,80.5,2,2
332,21,0,33,9,77.8,5,4
332,22,0,62,10,83.2,8,2
332,23,0,34,10,76.0,7,3
332,24,0,63,14,75.9,7,7
332,25,0,78,17,75.5,12,5
332,26,0,63,12,79.3,9,3
332,27,0,26,8,77.5,7,1
332,28,0,41,10,81.5,6,4
332,29,0,73,14,77.7,9,5
332,30,0,60,13,78.4,9,4
333,1,1,40,11,35.0,4,7
333,2,1,67,17,36.9,12,5
333,3,1,45,12,36.1,7,5
333,4,1,60,15,35.6,9,6
333,5,1,38,12,36.2,5,7
333,6,1,36,10,32.1,5,5
333,7,1,36,13,34.9,6,7
333,8,1,54,19,37.7,11,8
333,9,1,69,25,40.4,14,11
333,10,1,73,28,39.3,18,10
333,11,1,47,17,35.9,8,9
333,12,1,47,19,35.7,13,6
333,13,1,43,17,38.9,10,7
333,14,1,32,14,35.0,8,6
333,15,1,73,29,40.9,9,20
333,16,1,49,20,35.9,9,11
333,17,1,45,21,37.7,11,10
333,18,1,39,19,38.3,11,8
333,19,1,58,29,37.3,19,10
333,20,1,48,26,38.3,12,14
333,21,1,44,22,35.0,15,7
333,22,1,52,28,39.2,16,12
333,23,1,52,30,38.2,15,15
333,24,1,16,10,36.4,6,4
333,25,1,73,40,41.8,26,14
333,26,1,34,21,34.4,7,14
333,27,1,38,22,37.0,12,10
333,28,1,59,34,37.1,17,17
333,29,1,35,24,37.3,11,13
333,30,1,64,43,37.1,27,16
334,1,1,70,18,53.6,9,9
334,2,1,48,12,57.2,6,6
334,3,1,66,17,52.9,10,7
334,4,1,27,8,53.2,1,7
334,5,1,37,10,53.0,4,6
334,6,1,22,8,52.0,2,6
334,7,1,21,10,52.0,6,4
334,8,1,24,12,52.5,6,6
334,9,1,57,20,55.0,5,15
334,10,1,32,13,55.1,8,5
334,11,1,45,16,54.1,9,7
334,12,1,39,18,53.5,13,5
334,13,1,22,10,51.8,5,5
334,14,1,35,16,52.4,9,7
334,15,1,52,20,51.0,12,8
334,16,1,33,15,55.6,8,7
334,17,1,38,16,55.3,6,10
334,18,1,50,25,57.9,12,13
334,19,1,38,18,50.9,6,12
334,20,1,32,16,56.9,6,10
334,21,1,32,16,54.3,9,7
334,22,1,39,22,54.2,16,6
334,23,1,37,20,52.0,10,10
334,24,1,57,31,51.9,14,17
334,25,1,35,23,57.9,17,6
334,26,1,36,22,51.7,10,12
334,27,1,28,16,50.4,8,8
334,28,1,34,24,56.3,13,11
334,29,1,40,24,56.1,13,11
334,30,1,34,22,52.5,16,6
335,1,1,69,15,34.3,6,9
335,2,1,70,17,34.0,6,11
335,3,1,62,14,34.7,8,6
335,4,1,44,12,35.1,9,3
335,5,1,95,26,34.8,10,16
335,6,1,43,14,35.8,7,7
335,7,1,26,12,33.0,5,7
335,8,1,93,29,35.2,11,18
335,9,1,54,18,31.5,12,6
335,10,1,74,25,35.8,11,14
335,11,1,86,33,33.8,12,21
335,12,1,58,24,33.2,12,12
335,13,1,40,16,31.5,5,11
335,14,1,47,19,30.7,10,9
335,15,1,71,31,33.6,11,20
335,16,1,63,27,37.2,13,14
335,17,1,48,22,33.2,13,9
335,18,1,76,36,35.8,19,17
335,19,1,89,40,33.1,20,20
335,20,1,42,19,31.9,6,13
335,21,1,42,22,29.7,9,13
335,22,1,51,30,31.2,12,18
335,23,1,73,38,32.4,14,24
335,24,1,60,33,29.4,21,12
335,25,1,52,31,37.7,18,13
335,26,1,70,41,31.2,11,30
335,27,1,48,28,31.1,14,14
335,28,1,49,28,32.9,13,15
335,29,1,59,35,34.4,17,18
335,30,1,59,37,30.4,17,20
336,1,0,127,9,62.8,2,7
336,2,0,111,10,62.5,2,8
336,3,0,106,12,63.6,5,7
336,4,0,140,12,65.2,3,9
336,5,0,130,16,66.2,9,7
336,6,0,79,8,66.9,5,3
336,7,0,89,8,64.8,2,6
336,8,0,116,14,64.7,2,12
336,9,0,103,11,65.7,4,7
336,10,0,110,15,62.0,5,10
336,11,0,133,17,61.0,6,11
336,12,0,120,18,60.7,7,11
336,13,0,65,11,64.0,4,7
336,14,0,73,10,64.8,3,7
336,15,0,139,21,70.1,7,14
336,16,0,114,17,64.0,6,11
336,17,0,108,17,65.5,3,14
336,18,0,118,20,62.3,7,13
336,19,0,100,16,66.1,6,10
336,20,0,77,13,63.4,5,8
336,21,0,74,17,65.1,9,8
336,22,0,121,19,62.8,6,13
336,23,0,122,24,61.2,6,18
336,24,0,123,22,64.4,12,10
336,25,0,110,22,64.6,12,10
336,26,0,139,28,62.7,8,20
336,27,0,76,15,62.7,8,7
336,28,0,88,17,61.7,7,10
336,29,0,104,21,63.7,5,16
336,30,0,141,31,62.9,15,16
337,1,0,118,12,71.6,10,2
337,2,0,114,9,73.9,6,3
337,3,0,109,8,72.5,3,5
337,4,0,123,12,74.1,10,2
337,5,0,110,10,74.3,9,1
337,6,0,92,11,69.0,8,3
337,7,0,89,10,73.9,7,3
337,8,0,86,10,74.6,7,3
337,9,0,89,14,70.9,11,3
337,10,0,118,15,72.3,6,9
337,11,0,100,12,74.8,10,2
337,12,0,109,14,72.7,7,7
337,13,0,94,15,73.5,11,4
337,14,0,80,10,72.9,8,2
337,15,0,98,14,77.6,9,5
337,16,0,116,17,72.4,12,5
337,17,0,98,14,74.8,10,4
337,18,0,134,22,72.3,13,9
337,19,0,132,23,75.0,16,7
337,20,0,71,14,68.2,10,4
337,21,0,74,12,75.3,11,1
337,22,0,99,19,72.1,12,7
337,23,0,125,25,73.9,14,11
337,24,0,82,18,76.8,9,9
337,25,0,108,21,76.1,17,4
337,26,0,132,24,73.2,16,8
337,27,0,85,18,75.4,13,5
337,28,0,78,16,73.8,10,6
337,29,0,141,29,74.2,15,14
337,30,0,112,23,74.5,14,9
338,1,0,28,3,35.6,2,1
338,2,0,28,5,34.8,3,2
338,3,0,49,4,35.6,3,1
338,4,0,29,8,35.0,4,4
338,5,0,34,5,38.1,4,1
338,6,0,31,5,35.4,2,3
338,7,0,26,3,28.8,2,1
338,8,0,49,8,35.8,6,2
338,9,0,65,10,32.3,7,3
338,10,0,37,7,30.9,4,3
338,11,0,1,1,36.1,0,1
338,12,0,51,9,33.8,2,7
338,13,0,24,2,29.0,1,1
338,14,0,14,4,31.9,2,2
338,15,0,19,3,29.8,0,3
338,16,0,35,7,36.1,4,3
338,17,0,46,10,30.5,5,5
338,18,0,33,4,30.5,2,2
338,19,0,43,7,33.0,3,4
338,20,0,6,2,31.5,0,2
338,21,0,33,6,32.9,2,4
338,22,0,13,2,33.7,1,1
338,23,0,26,5,30.9,2,3
338,24,0,23,4,33.0,2,2
338,25,0,24,6,34.7,4,2
338,26,0,61,12,34.5,8,4
338,27,0,16,4,32.6,3,1
338,28,0,27,7,33.1,4,3
338,29,0,52,12,32.8,8,4
338,30,0,25,7,34.3,5,2
339,1,0,109,9,52.3,3,6
339,2,0,95,8,51.5,7,1
339,3,0,111,11,53.3,7,4
339,4,0,102,11,53.0,9,2
339,5,0,69,9,55.3,6,3
339,6,0,79,12,52.3,7,5
339,7,0,64,8,52.9,6,2
339,8,0,97,10,53.1,5,5
339,9,0,106,13,51.2,9,4
339,10,0,71,9,50.1,7,2
339,11,0,111,13,55.2,8,5
339,12,0,61,10,50.9,7,3
339,13,0,66,8,50.4,3,5
339,14,0,40,7,53.6,5,2
339,15,0,69,16,51.1,12,4
339,16,0,94,14,48.8,10,4
339,17,0,70,14,48.3,6,8
339,18,0,77,15,54.3,12,3
339,19,0,95,17,56.6,12,5
339,20,0,72,12,52.9,6,6
339,21,0,49,9,51.3,6,3
339,22,0,103,16,52.2,7,9
339,23,0,73,13,53.8,4,9
339,24,0,97,17,49.1,9,8
339,25,0,80,18,50.3,13,5
339,26,0,87,15,52.6,11,4
339,27,0,56,14,50.0,12,2
339,28,0,76,18,53.9,11,7
339,29,0,116,24,55.4,16,8
339,30,0,83,17,50.9,13,4
340,1,0,24,2,46.8,1,1
340,2,0,42,6,44.1,4,2
340,3,0,25,4,39.6,3,1
340,4,0,43,3,45.0,3,0
340,5,0,52,4,43.5,2,2
340,6,0,16,2,46.8,1,1
340,7,0,37,3,42.4,1,2
340,8,0,28,4,46.8,3,1
340,9,0,41,7,46.2,4,3
340,10,0,56,6,44.3,4,2
340,11,0,42,5,44.6,5,0
340,12,0,65,9,45.4,5,4
340,13,0,14,3,45.1,3,0
340,14,0,24,4,45.5,2,2
340,15,0,18,2,48.2,1,1
340,16,0,30,5,46.8,5,0
340,17,0,42,8,45.6,5,3
340,18,0,34,5,45.6,5,0
340,19,0,47,9,43.4,7,2
340,20,0,26,5,49.0,4,1
340,21,0,29,5,41.6,4,1
340,22,0,25,6,46.5,5,1
340,23,0,38,8,46.6,5,3
340,24,0,36,8,44.1,3,5
340,25,0,39,7,41.9,6,1
340,26,0,33,8,45.9,6,2
340,27,0,28,5,46.1,2,3
340,28,0,15,3,47.0,2,1
340,29,0,4,5,43.1,3,2
340,30,0,15,6,45.6,4,2
341,1,0,33,2,50.2,2,0
341,2,0,17,1,46.9,0,1
341,3,0,20,4,49.1,2,2
341,4,0,29,3,48.9,2,1
341,5,0,40,4,50.4,1,3
341,6,0,31,8,47.1,5,3
341,7,0,31,6,47.4,3,3
341,8,0,68,11,49.9,6,5
341,9,0,27,5,49.4,1,4
341,10,0,38,7,49.2,4,3
341,11,0,53,8,48.9,3,5
341,12,0,24,4,51.9,2,2
341,13,0,26,5,50.1,3,2
341,14,0,22,7,48.6,4,3
341,15,0,50,7,59.3,3,4
341,16,0,56,9,47.7,4,5
341,17,0,63,10,51.8,3,7
341,18,0,30,6,48.9,2,4
341,19,0,37,6,53.6,3,3
341,20,0,22,4,50.0,3,1
341,21,0,27,8,50.8,5,3
341,22,0,18,3,49.6,2,1
341,23,0,19,4,47.8,2,2
341,24,0,33,8,45.8,3,5
341,25,0,17,6,48.8,3,3
341,26,0,59,12,49.0,7,5
341,27,0,10,3,50.2,2,1
341,28,0,27,7,49.9,4,3
341,29,0,26,5,49.1,3,2
341,30,0,57,12,45.2,3,9
342,1,0,118,10,77.8,8,2
342,2,0,92,9,80.7,3,6
342,3,0,128,10,76.8,3,7
342,4,0,115,11,78.7,6,5
342,5,0,148,15,78.5,7,8
342,6,0,86,8,78.3,5,3
342,7,0,76,8,75.6,3,5
342,8,0,116,13,80.2,7,6
342,9,0,121,16,74.9,8,8
342,10,0,108,13,78.4,4,9
342,11,0,145,19,74.8,8,11
342,12,0,139,19,81.7,10,9
342,13,0,77,11,78.3,6,5
342,14,0,85,15,78.8,10,5
342,15,0,117,16,66.2,4,12
342,16,0,109,15,74.0,7,8
342,17,0,122,19,79.7,9,10
342,18,0,99,18,76.6,11,7
342,19,0,127,20,78.9,11,9
342,20,0,95,18,79.0,10,8
342,21,0,80,14,79.5,6,8
342,22,0,105,21,78.6,8,13
342,23,0,122,21,79.6,11,10
342,24,0,103,18,75.3,12,6
342,25,0,105,19,79.2,15,4
342,26,0,110,25,75.9,11,14
342,27,0,83,20,76.9,8,12
342,28,0,57,12,80.1,8,4
342,29,0,118,25,79.3,14,11
342,30,0,102,22,79.1,12,10
343,1,0,80,10,73.1,2,8
343,2,0,88,8,71.2,4,4
343,3,0,77,10,73.5,7,3
343,4,0,68,7,71.1,5,2
343,5,0,81,7,74.8,6,1
343,6,0,59,10,73.2,6,4
343,7,0,51,5,69.5,4,1
343,8,0,56,7,70.6,3,4
343,9,0,48,8,74.0,5,3
343,10,0,100,13,70.0,10,3
343,11,0,76,8,70.5,4,4
343,12,0,71,11,71.7,8,3
343,13,0,50,9,73.6,7,2
343,14,0,51,8,75.8,6,2
343,15,0,58,9,74.3,3,6
343,16,0,59,10,69.0,5,5
343,17,0,71,14,69.3,12,2
343,18,0,74,15,68.4,3,12
343,19,0,78,13,69.9,10,3
343,20,0,42,7,71.7,4,3
343,21,0,44,10,70.1,3,7
343,22,0,100,18,72.6,7,11
343,23,0,76,12,69.6,6,6
343,24,0,54,12,71.9,3,9
343,25,0,55,10,71.8,8,2
343,26,0,98,21,74.7,10,11
343,27,0,51,11,74.0,5,6
343,28,0,76,18,73.4,10,8
343,29,0,65,13,72.2,9,4
343,30,0,89,19,72.4,6,13
344,1,0,10,0,21.9,0,0
344,2,0,50,3,21.0,0,3
344,3,0,7,2,22.1,1,1
344,4,0,13,3,20.5,0,3
344,5,0,14,2,22.5,1,1
344,6,0,7,1,20.3,1,0
344,7,0,0,2,22.3,0,2
344,8,0,63,9,21.2,3,6
344,9,0,28,8,18.1,6,2
344,10,0,0,1,18.4,1,0
344,11,0,37,6,24.1,4,2
344,12,0,3,1,16.7,0,1
344,13,0,22,3,22.5,2,1
344,14,0,11,5,17.8,3,2
344,15,0,30,6,21.5,5,1
344,16,0,19,5,23.8,2,3
344,17,0,8,3,19.4,3,0
344,18,0,34,5,20.3,2,3
344,19,0,0,3,23.7,3,0
344,20,0,19,4,19.3,4,0
344,21,0,20,6,18.3,5,1
344,22,0,36,9,18.0,5,4
344,23,0,14,5,20.3,4,1
344,24,0,21,6,21.7,4,2
344,25,0,12,6,18.0,4,2
344,26,0,24,7,20.0,6,1
344,27,0,6,4,22.9,2,2
344,28,0,27,8,19.4,5,3
344,29,0,13,2,26.2,2,0
344,30,0,13,3,21.3,3,0
345,1,0,36,4,26.2,2,2
345,2,0,41,3,31.2,2,1
345,3,0,40,7,28.1,2,5
345,4,0,64,6,29.8,4,2
345,5,0,53,8,27.2,3,5
345,6,0,40,5,27.6,1,4
345,7,0,28,4,23.5,2,2
345,8,0,17,3,24.6,3,0
345,9,0,44,5,26.9,2,3
345,10,0,62,8,24.7,6,2
345,11,0,43,5,25.6,4,1
345,12,0,25,5,26.3,2,3
345,13,0,23,3,24.8,2,1
345,14,0,25,5,23.8,4,1
345,15,0,45,8,23.2,3,5
345,16,0,34,6,25.9,3,3
345,17,0,64,10,25.1,4,6
345,18,0,31,5,24.2,0,5
345,19,0,49,8,29.0,5,3
345,20,0,9,2,22.6,1,1
345,21,0,31,6,23.1,4,2
345,22,0,72,15,27.7,4,11
345,23,0,40,9,28.5,7,2
345,24,0,47,10,26.8,3,7
345,25,0,43,8,26.9,3,5
345,26,0,30,6,25.9,4,2
345,27,0,36,9,25.0,5,4
345,28,0,30,7,23.4,5,2
345,29,0,44,11,27.5,4,7
345,30,0,23,5,24.8,2,3
346,1,1,28,6,63.1,3,3
346,2,1,60,13,59.2,7,6
346,3,1,71,18,60.3,8,10
346,4,1,63,17,57.5,8,9
346,5,1,53,15,64.7,6,9
346,6,1,45,17,60.1,8,9
346,7,1,24,10,61.0,3,7
346,8,1,75,24,60.8,16,8
346,9,1,74,24,61.2,14,10
346,10,1,63,21,60.7,6,15
346,11,1,57,20,59.1,11,9
346,12,1,36,13,59.3,8,5
346,13,1,32,12,58.6,7,5
346,14,1,28,14,57.7,7,7
346,15,1,51,22,61.6,9,13
346,16,1,71,34,61.9,21,13
346,17,1,64,32,60.3,15,17
346,18,1,86,40,57.1,22,18
346,19,1,83,38,60.5,21,17
346,20,1,31,15,58.9,6,9
346,21,1,44,27,57.6,16,11
346,22,1,94,49,56.4,18,31
346,23,1,92,47,60.3,26,21
346,24,1,79,41,57.4,19,22
346,25,1,60,33,55.7,19,14
346,26,1,63,37,60.7,20,17
346,27,1,46,27,62.4,11,16
346,28,1,48,28,62.4,11,17
346,29,1,42,27,60.5,10,17
346,30,1,38,24,58.7,14,10
347,1,0,88,9,73.9,3,6
347,2,0,63,5,73.5,1,4
347,3,0,81,11,72.8,3,8
347,4,0,70,8,74.2,3,5
347,5,0,88,7,76.2,1,6
347,6,0,54,7,72.1,6,1
347,7,0,39,4,72.6,1,3
347,8,0,78,10,70.4,3,7
347,9,0,91,10,75.3,4,6
347,10,0,40,4,73.5,0,4
347,11,0,81,12,72.6,5,7
347,12,0,63,7,76.1,1,6
347,13,0,60,10,73.5,4,6
347,14,0,59,8,74.0,4,4
347,15,0,98,15,73.3,4,11
347,16,0,78,13,72.1,4,9
347,17,0,97,15,71.3,6,9
347,18,0,89,15,77.0,6,9
347,19,0,99,18,74.7,6,12
347,20,0,69,13,69.9,3,10
347,21,0,59,13,70.3,5,8
347,22,0,73,13,73.5,4,9
347,23,0,59,10,75.2,4,6
347,24,0,99,18,74.6,6,12
347,25,0,57,10,73.4,2,8
347,26,0,76,15,69.7,5,10
347,27,0,64,13,76.7,5,8
347,28,0,86,18,71.2,7,11
347,29,0,68,15,74.1,4,11
347,30,0,86,19,70.7,9,10
348,1,0,115,10,78.7,6,4
348,2,0,97,11,77.1,5,6
348,3,0,95,7,77.5,2,5
348,4,0,107,13,78.3,7,6
348,5,0,112,11,78.9,4,7
348,6,0,78,7,76.5,2,5
348,7,0,68,8,73.9,5,3
348,8,0,107,11,81.3,7,4
348,9,0,99,12,77.0,5,7
348,10,0,118,15,79.2,9,6
348,11,0,113,15,75.3,8,7
348,12,0,124,16,82.2,10,6
348,13,0,93,12,75.9,6,6
348,14,0,76,12,74.6,7,5
348,15,0,139,20,88.9,13,7
348,16,0,116,16,77.9,8,8
348,17,0,102,16,75.7,5,11
348,18,0,115,18,75.2,8,10
348,19,0,113,20,75.9,11,9
348,20,0,100,17,78.4,8,9
348,21,0,78,15,74.3,7,8
348,22,0,82,16,74.1,9,7
348,23,0,136,24,78.5,13,11
348,24,0,110,22,75.0,11,11
348,25,0,139,25,77.3,14,11
348,26,0,132,25,77.7,13,12
348,27,0,84,18,77.5,11,7
348,28,0,79,21,78.1,8,13
348,29,0,108,22,75.4,14,8
348,30,0,127,27,78.0,14,13
349,1,1,129,30,44.2,22,8
349,2,1,112,29,43.8,17,12
349,3,1,114,28,41.0,12,16
349,4,1,130,35,43.4,11,24
349,5,1,126,36,47.7,17,19
349,6,1,56,18,40.3,11,7
349,7,1,93,30,39.4,16,14
349,8,1,122,39,43.6,15,24
349,9,1,112,37,45.6,19,18
349,10,1,102,37,45.4,21,16
349,11,1,122,45,44.9,23,22
349,12,1,117,45,45.6,31,14
349,13,1,75,31,44.8,16,15
349,14,1,77,31,43.6,17,14
349,15,1,126,52,53.6,30,22
349,16,1,120,52,42.6,21,31
349,17,1,121,55,43.4,27,28
349,18,1,113,49,43.3,26,23
349,19,1,114,53,46.7,21,32
349,20,1,72,34,46.6,16,18
349,21,1,79,38,41.2,19,19
349,22,1,104,51,42.6,26,25
349,23,1,128,66,42.3,30,36
349,24,1,111,60,43.8,32,28
349,25,1,118,64,42.0,26,38
349,26,1,100,56,43.8,32,24
349,27,1,88,49,43.3,19,30
349,28,1,78,44,41.1,23,21
349,29,1,127,75,44.4,40,35
349,30,1,115,70,47.0,31,39
350,1,0,85,10,52.8,3,7
350,2,0,90,7,49.1,3,4
350,3,0,103,9,51.2,7,2
350,4,0,98,11,52.0,9,2
350,5,0,100,11,55.8,5,6
350,6,0,65,7,55.2,4,3
350,7,0,69,8,53.5,6,2
350,8,0,122,17,54.7,12,5
350,9,0,100,15,50.9,8,7
350,10,0,112,17,53.6,12,5
350,11,0,107,13,58.6,12,1
350,12,0,89,12,55.8,10,2
350,13,0,59,7,54.2,3,4
350,14,0,54,10,55.7,7,3
350,15,0,93,13,54.4,7,6
350,16,0,78,14,55.4,12,2
350,17,0,83,12,55.7,8,4
350,18,0,99,15,51.4,11,4
350,19,0,128,21,50.3,13,8
350,20,0,76,14,55.3,9,5
350,21,0,66,12,55.2,7,5
350,22,0,108,25,56.6,13,12
350,23,0,95,17,53.9,11,6
350,24,0,70,14,55.5,8,6
350,25,0,115,22,55.4,12,10
350,26,0,90,16,55.7,12,4
350,27,0,50,10,53.6,6,4
350,28,0,79,18,57.9,13,5
350,29,0,87,18,48.3,13,5
350,30,0,117,25,55.4,18,7
351,1,0,77,9,29.3,5,4
351,2,0,93,10,25.8,4,6
351,3,0,79,7,28.7,2,5
351,4,0,71,9,30.0,3,6
351,5,0,62,7,27.0,2,5
351,6,0,29,4,30.6,1,3
351,7,0,49,7,28.7,3,4
351,8,0,69,8,34.2,0,8
351,9,0,45,7,28.8,3,4
351,10,0,66,7,30.7,3,4
351,11,0,78,10,30.0,6,4
351,12,0,60,8,29.8,4,4
351,13,0,58,8,30.0,4,4
351,14,0,38,5,29.1,2,3
351,15,0,75,11,32.5,5,6
351,16,0,84,12,32.2,3,9
351,17,0,37,6,28.8,0,6
351,18,0,96,17,29.3,6,11
351,19,0,77,12,32.3,8,4
351,20,0,39,10,30.1,2,8
351,21,0,39,7,30.9,3,4
351,22,0,64,12,29.0,5,7
351,23,0,38,7,26.1,3,4
351,24,0,52,13,28.6,7,6
351,25,0,33,5,30.4,1,4
351,26,0,50,10,34.1,7,3
351,27,0,38,10,32.3,6,4
351,28,0,41,10,27.7,4,6
351,29,0,57,11,29.4,5,6
351,30,0,61,15,28.9,4,11
352,1,1,57,18,27.5,7,11
352,2,1,22,7,20.1,4,3
352,3,1,43,11,21.6,7,4
352,4,1,32,8,23.6,2,6
352,5,1,46,12,24.7,5,7
352,6,1,30,11,19.0,5,6
352,7,1,13,3,21.2,2,1
352,8,1,31,12,20.8,4,8
352,9,1,33,12,24.1,10,2
352,10,1,33,12,19.6,4,8
352,11,1,25,11,23.9,7,4
352,12,1,38,14,23.3,6,8
352,13,1,35,16,22.2,5,11
352,14,1,19,9,21.8,3,6
352,15,1,37,16,17.7,7,9
352,16,1,36,16,24.9,5,11
352,17,1,40,19,21.7,8,11
352,18,1,58,27,23.8,16,11
352,19,1,38,19,20.6,6,13
352,20,1,9,8,22.1,5,3
352,21,1,26,14,23.9,4,10
352,22,1,12,7,21.3,2,5
352,23,1,37,22,24.9,7,15
352,24,1,53,29,23.4,15,14
352,25,1,40,23,25.3,13,10
352,26,1,19,17,21.2,10,7
352,27,1,28,15,24.2,5,10
352,28,1,23,17,20.0,10,7
352,29,1,21,13,20.0,10,3
352,30,1,22,15,19.6,7,8
353,1,0,67,4,58.1,0,4
353,2,0,109,8,63.2,4,4
353,3,0,71,6,64.5,4,2
353,4,0,116,12,55.4,4,8
353,5,0,123,16,60.4,7,9
353,6,0,73,7,57.4,1,6
353,7,0,64,10,60.2,2,8
353,8,0,73,9,60.2,4,5
353,9,0,74,9,60.1,4,5
353,10,0,110,14,62.1,2,12
353,11,0,112,13,59.8,6,7
353,12,0,91,12,60.1,6,6
353,13,0,82,12,62.3,2,10
353,14,0,74,12,64.5,4,8
353,15,0,116,16,55.5,5,11
353,16,0,90,12,60.2,3,9
353,17,0,80,14,61.9,4,10
353,18,0,87,18,59.1,7,11
353,19,0,112,18,60.5,7,11
353,20,0,60,10,58.7,3,7
353,21,0,63,12,60.3,6,6
353,22,0,94,17,58.4,4,13
353,23,0,91,19,62.7,7,12
353,24,0,96,18,58.9,5,13
353,25,0,83,14,58.7,6,8
353,26,0,110,21,57.9,4,17
353,27,0,60,13,61.0,6,7
353,28,0,64,14,60.7,6,8
353,29,0,78,20,62.5,10,10
353,30,0,93,20,58.0,5,15
354,1,0,3,4,54.8,1,3
354,2,0,14,1,54.3,1,0
354,3,0,2,4,51.7,2,2
354,4,0,9,2,55.9,1,1
354,5,0,0,1,52.1,1,0
354,6,0,9,3,55.5,2,1
354,7,0,0,4,56.9,1,3
354,8,0,21,5,51.6,1,4
354,9,0,0,1,53.2,1,0
354,10,0,35,6,56.5,6,0
354,11,0,44,7,49.1,3,4
354,12,0,20,3,53.9,2,1
354,13,0,0,4,56.1,3,1
354,14,0,0,1,55.0,0,1
354,15,0,22,2,55.6,2,0
354,16,0,0,2,54.8,1,1
354,17,0,1,2,56.0,1,1
354,18,0,0,2,54.7,1,1
354,19,0,20,4,57.8,1,3
354,20,0,15,8,56.9,3,5
354,21,0,18,3,57.9,0,3
354,22,0,0,1,56.1,0,1
354,23,0,7,3,56.8,1,2
354,24,0,31,6,56.3,2,4
354,25,0,0,1,49.6,0,1
354,26,0,36,10,58.2,6,4
354,27,0,7,4,55.6,1,3
354,28,0,0,1,56.0,0,1
354,29,0,28,11,54.1,5,6
354,30,0,27,8,56.2,5,3
355,1,0,72,7,37.9,2,5
355,2,0,50,4,36.9,0,4
355,3,0,83,6,38.5,1,5
355,4,0,54,6,39.9,2,4
355,5,0,85,7,39.0,2,5
355,6,0,52,5,40.1,1,4
355,7,0,50,6,40.7,2,4
355,8,0,47,6,38.8,2,4
355,9,0,80,12,39.4,3,9
355,10,0,57,8,40.9,4,4
355,11,0,96,13,36.1,5,8
355,12,0,46,8,40.9,2,6
355,13,0,49,7,37.2,2,5
355,14,0,25,4,33.5,2,2
355,15,0,63,14,32.3,2,12
355,16,0,60,13,35.8,4,9
355,17,0,74,13,41.0,8,5
355,18,0,56,12,39.0,4,8
355,19,0,59,9,39.7,1,8
355,20,0,28,5,35.1,3,2
355,21,0,55,10,37.9,7,3
355,22,0,44,8,37.4,3,5
355,23,0,88,16,38.2,9,7
355,24,0,85,18,35.6,5,13
355,25,0,45,15,39.6,9,6
355,26,0,86,19,40.0,5,14
355,27,0,61,13,40.9,6,7
355,28,0,34,8,35.3,3,5
355,29,0,52,15,34.2,4,11
355,30,0,17,5,44.5,1,4
356,1,0,77,6,49.7,4,2
356,2,0,38,5,49.9,2,3
356,3,0,59,5,50.9,3,2
356,4,0,64,6,51.4,4,2
356,5,0,46,7,51.0,6,1
356,6,0,30,5,50.7,3,2
356,7,0,41,7,49.8,6,1
356,8,0,70,10,51.4,5,5
356,9,0,29,5,53.6,4,1
356,10,0,47,5,53.4,3,2
356,11,0,54,9,50.5,7,2
356,12,0,46,5,53.0,4,1
356,13,0,35,6,51.6,5,1
356,14,0,45,5,46.7,5,0
356,15,0,64,9,57.5,8,1
356,16,0,55,10,50.4,7,3
356,17,0,32,5,49.0,4,1
356,18,0,76,15,48.9,11,4
356,19,0,98,17,48.5,9,8
356,20,0,39,7,50.0,4,3
356,21,0,30,8,51.9,5,3
356,22,0,58,11,48.6,7,4
356,23,0,62,11,49.4,7,4
356,24,0,72,12,48.9,8,4
356,25,0,65,13,52.8,9,4
356,26,0,34,7,53.3,3,4
356,27,0,50,10,51.8,6,4
356,28,0,37,8,48.6,4,4
356,29,0,65,12,48.3,6,6
356,30,0,43,10,50.2,10,0
357,1,1,86,20,65.7,8,12
357,2,1,99,25,67.5,15,10
357,3,1,133,33,67.6,18,15
357,4,1,107,27,68.7,18,9
357,5,1,86,23,67.0,10,13
357,6,1,57,21,64.4,11,10
357,7,1,61,19,67.5,7,12
357,8,1,95,32,67.9,15,17
357,9,1,122,39,64.6,22,17
357,10,1,139,48,67.9,23,25
357,11,1,96,35,68.5,17,18
357,12,1,82,30,69.2,12,18
357,13,1,70,29,67.0,9,20
357,14,1,62,28,63.4,11,17
357,15,1,105,45,69.8,25,20
357,16,1,97,44,64.8,30,14
357,17,1,129,60,67.0,24,36
357,18,1,105,48,65.1,19,29
357,19,1,99,45,68.5,23,22
357,20,1,65,32,66.4,20,12
357,21,1,78,38,67.7,20,18
357,22,1,94,49,66.7,31,18
357,23,1,74,39,67.5,15,24
357,24,1,99,51,67.3,25,26
357,25,1,95,51,64.3,21,30
357,26,1,116,65,66.5,29,36
357,27,1,79,44,65.6,14,30
357,28,1,48,27,64.4,8,19
357,29,1,89,53,66.8,27,26
357,30,1,73,44,67.1,20,24
358,1,1,78,17,50.5,11,6
358,2,1,87,22,49.3,8,14
358,3,1,82,20,49.8,6,14
358,4,1,90,22,44.9,11,11
358,5,1,92,26,45.4,6,20
358,6,1,83,26,48.5,14,12
358,7,1,64,19,48.4,9,10
358,8,1,79,25,49.0,15,10
358,9,1,84,28,50.2,17,11
358,10,1,75,27,41.8,9,18
358,11,1,74,27,45.2,11,16
358,12,1,96,36,46.0,23,13
358,13,1,70,27,48.4,14,13
358,14,1,51,24,48.8,11,13
358,15,1,69,29,49.4,12,17
358,16,1,91,39,49.0,20,19
358,17,1,65,28,50.3,16,12
358,18,1,119,54,45.9,33,21
358,19,1,82,39,44.8,19,20
358,20,1,70,34,46.6,19,15
358,21,1,58,29,48.5,16,13
358,22,1,96,51,47.6,31,20
358,23,1,101,51,45.8,25,26
358,24,1,88,45,47.5,19,26
358,25,1,91,49,49.3,27,22
358,26,1,87,49,43.1,22,27
358,27,1,65,36,49.5,22,14
358,28,1,57,33,47.7,16,17
358,29,1,82,50,48.8,30,20
358,30,1,103,62,47.5,30,32
359,1,0,56,6,36.0,4,2
359,2,0,81,6,40.3,1,5
359,3,0,47,6,39.1,3,3
359,4,0,73,10,34.6,8,2
359,5,0,69,7,39.9,4,3
359,6,0,54,6,37.4,2,4
359,7,0,45,4,39.0,3,1
359,8,0,71,7,36.3,3,4
359,9,0,63,8,39.0,4,4
359,10,0,74,9,35.5,6,3
359,11,0,78,10,41.9,6,4
359,12,0,85,12,38.5,7,5
359,13,0,40,7,39.9,6,1
359,14,0,48,7,38.7,5,2
359,15,0,63,8,47.7,7,1
359,16,0,61,12,38.1,10,2
359,17,0,35,10,39.6,9,1
359,18,0,93,15,37.7,7,8
359,19,0,42,9,39.5,7,2
359,20,0,48,8,39.0,5,3
359,21,0,18,3,37.1,2,1
359,22,0,61,11,37.5,6,5
359,23,0,82,15,39.7,11,4
359,24,0,63,11,38.3,5,6
359,25,0,63,13,34.3,11,2
359,26,0,86,16,35.6,8,8
359,27,0,56,12,33.9,8,4
359,28,0,69,14,38.8,10,4
359,29,0,68,15,37.3,15,0
359,30,0,89,19,38.2,17,2
360,1,1,88,19,25.9,13,6
360,2,1,64,14,21.2,7,7
360,3,1,106,27,25.6,12,15
360,4,1,81,24,20.4,12,12
360,5,1,110,31,20.3,17,14
360,6,1,59,16,23.8,9,7
360,7,1,81,24,22.1,11,13
360,8,1,80,26,24.2,18,8
360,9,1,90,29,23.0,17,12
360,10,1,116,40,24.1,25,15
360,11,1,108,38,23.8,20,18
360,12,1,87,31,23.1,9,22
360,13,1,66,25,22.6,18,7
360,14,1,66,26,23.6,13,13
360,15,1,127,50,23.4,34,16
360,16,1,123,53,24.9,26,27
360,17,1,118,54,21.7,25,29
360,18,1,79,35,23.9,22,13
360,19,1,101,45,23.4,25,20
360,20,1,58,28,21.9,12,16
360,21,1,82,42,20.6,18,24
360,22,1,103,53,22.3,26,27
360,23,1,98,53,21.0,27,26
360,24,1,86,49,24.0,24,25
360,25,1,100,54,22.7,30,24
360,26,1,96,55,23.6,28,27
360,27,1,62,37,21.6,18,19
360,28,1,69,42,19.0,18,24
360,29,1,92,55,26.6,29,26
360,30,1,110,70,21.1,45,25
361,1,0,45,8,75.5,4,4
361,2,0,45,3,80.3,1,2
361,3,0,43,6,77.6,3,3
361,4,0,56,6,73.8,1,5
361,5,0,46,6,75.4,3,3
361,6,0,43,8,74.2,4,4
361,7,0,49,7,76.7,1,6
361,8,0,69,8,76.2,1,7
361,9,0,95,11,76.6,5,6
361,10,0,56,9,76.5,4,5
361,11,0,24,5,77.6,1,4
361,12,0,44,7,75.2,1,6
361,13,0,34,6,76.4,4,2
361,14,0,46,7,76.3,0,7
361,15,0,48,8,82.3,2,6
361,16,0,67,12,74.5,5,7
361,17,0,27,5,76.4,0,5
361,18,0,67,11,75.5,4,7
361,19,0,62,10,74.4,1,9
361,20,0,23,4,73.9,2,2
361,21,0,38,8,73.7,4,4
361,22,0,35,6,74.5,4,2
361,23,0,57,10,76.4,5,5
361,24,0,38,7,75.5,4,3
361,25,0,65,14,75.6,5,9
361,26,0,51,10,81.4,1,9
361,27,0,36,7,75.1,3,4
361,28,0,48,12,77.5,6,6
361,29,0,42,11,79.3,2,9
361,30,0,65,18,72.3,4,14
362,1,0,64,6,50.2,2,4
362,2,0,37,4,48.8,2,2
362,3,0,59,7,46.7,2,5
362,4,0,31,4,46.1,1,3
362,5,0,58,7,48.7,2,5
362,6,0,31,4,47.5,2,2
362,7,0,44,6,48.9,1,5
362,8,0,75,9,44.0,1,8
362,9,0,74,8,47.2,2,6
362,10,0,44,7,44.4,1,6
362,11,0,48,7,51.0,3,4
362,12,0,74,14,48.9,4,10
362,13,0,43,8,47.2,5,3
362,14,0,53,7,48.4,2,5
362,15,0,77,12,51.5,5,7
362,16,0,36,9,49.9,3,6
362,17,0,55,8,46.6,2,6
362,18,0,74,14,45.2,4,10
362,19,0,47,8,47.4,3,5
362,20,0,50,7,47.9,1,6
362,21,0,36,9,49.5,2,7
362,22,0,84,14,47.2,3,11
362,23,0,30,7,47.7,5,2
362,24,0,60,11,45.8,4,7
362,25,0,66,11,51.8,6,5
362,26,0,55,12,50.3,3,9
362,27,0,36,10,50.2,6,4
362,28,0,34,6,45.0,2,4
362,29,0,42,9,47.6,2,7
362,30,0,61,15,46.5,5,10
363,1,1,20,5,41.0,1,4
363,2,1,0,0,42.7,0,0
363,3,1,19,6,39.6,4,2
363,4,1,39,11,37.6,7,4
363,5,1,12,6,39.6,5,1
363,6,1,4,3,39.9,1,2
363,7,1,15,5,43.4,3,2
363,8,1,13,5,41.6,2,3
363,9,1,4,2,40.2,0,2
363,10,1,5,3,40.5,2,1
363,11,1,16,9,39.3,6,3
363,12,1,3,4,42.6,1,3
363,13,1,11,8,40.1,3,5
363,14,1,4,3,40.7,0,3
363,15,1,26,11,45.3,7,4
363,16,1,8,5,44.6,2,3
363,17,1,33,18,41.0,10,8
363,18,1,10,8,39.4,4,4
363,19,1,14,7,40.6,5,2
363,20,1,16,9,38.9,4,5
363,21,1,4,4,45.3,3,1
363,22,1,9,7,41.8,3,4
363,23,1,38,21,41.5,14,7
363,24,1,11,5,44.0,3,2
363,25,1,0,2,46.0,1,1
363,26,1,6,7,39.4,5,2
363,27,1,21,12,40.6,4,8
363,28,1,11,6,42.0,2,4
363,29,1,33,20,44.8,11,9
363,30,1,3,2,43.6,1,1
364,1,1,51,15,56.2,10,5
364,2,1,29,9,57.6,6,3
364,3,1,47,11,58.0,7,4
364,4,1,26,7,58.5,4,3
364,5,1,9,3,57.5,3,0
364,6,1,9,3,55.4,2,1
364,7,1,21,9,55.8,6,3
364,8,1,12,4,56.8,2,2
364,9,1,51,16,57.2,5,11
364,10,1,1,3,60.4,0,3
364,11,1,0,1,55.3,0,1
364,12,1,5,2,55.4,2,0
364,13,1,40,16,54.7,10,6
364,14,1,15,6,57.1,2,4
364,15,1,33,15,55.0,3,12
364,16,1,15,6,55.5,2,4
364,17,1,18,8,58.8,4,4
364,18,1,28,13,59.0,6,7
364,19,1,19,10,57.3,1,9
364,20,1,17,9,57.1,1,8
364,21,1,14,8,53.6,6,2
364,22,1,23,13,56.0,8,5
364,23,1,43,21,61.0,11,10
364,24,1,37,22,55.2,7,15
364,25,1,50,29,56.6,9,20
364,26,1,20,13,56.6,3,10
364,27,1,17,11,53.5,7,4
364,28,1,24,16,54.3,10,6
364,29,1,22,16,54.9,5,11
364,30,1,0,2,56.3,2,0
365,1,1,28,6,30.1,4,2
365,2,1,56,15,29.4,7,8
365,3,1,39,10,25.6,5,5
365,4,1,56,15,29.1,6,9
365,5,1,49,14,29.1,7,7
365,6,1,38,12,27.6,5,7
365,7,1,20,9,28.9,4,5
365,8,1,47,16,27.4,8,8
365,9,1,56,18,26.5,9,9
365,10,1,52,20,28.9,8,12
365,11,1,52,19,29.9,7,12
365,12,1,32,12,29.6,6,6
365,13,1,14,8,31.8,4,4
365,14,1,36,17,28.1,14,3
365,15,1,40,17,28.8,7,10
365,16,1,4,3,26.5,2,1
365,17,1,18,8,28.6,5,3
365,18,1,42,23,31.7,10,13
365,19,1,19,11,30.2,9,2
365,20,1,35,16,26.5,9,7
365,21,1,27,15,31.1,7,8
365,22,1,14,10,24.8,6,4
365,23,1,40,24,26.6,11,13
365,24,1,34,17,29.9,4,13
365,25,1,49,30,25.8,11,19
365,26,1,0,4,28.4,3,1
365,27,1,14,10,30.3,7,3
365,28,1,38,22,32.7,13,9
365,29,1,36,22,28.9,13,9
365,30,1,49,29,29.8,19,10
366,1,1,49,14,46.9,8,6
366,2,1,65,16,47.4,12,4
366,3,1,71,20,45.6,9,11
366,4,1,63,17,46.1,4,13
366,5,1,78,23,45.4,11,12
366,6,1,18,6,52.1,4,2
366,7,1,55,21,42.3,10,11
366,8,1,78,25,44.5,7,18
366,9,1,53,19,43.8,14,5
366,10,1,53,18,46.8,8,10
366,11,1,46,21,43.3,9,12
366,12,1,75,29,44.9,19,10
366,13,1,45,18,45.1,8,10
366,14,1,59,25,47.6,10,15
366,15,1,52,23,46.3,15,8
366,16,1,68,29,47.5,11,18
366,17,1,44,24,46.5,10,14
366,18,1,40,19,47.0,12,7
366,19,1,57,27,46.0,17,10
366,20,1,45,21,46.3,14,7
366,21,1,56,28,46.5,15,13
366,22,1,79,40,45.1,20,20
366,23,1,62,33,44.1,13,20
366,24,1,56,33,45.6,16,17
366,25,1,46,24,49.5,16,8
366,26,1,39,23,45.6,5,18
366,27,1,45,27,46.6,12,15
366,28,1,51,30,44.6,15,15
366,29,1,19,14,45.1,9,5
366,30,1,35,25,46.1,16,9
367,1,0,84,6,42.3,4,2
367,2,0,94,8,41.5,5,3
367,3,0,41,9,41.4,8,1
367,4,0,79,8,43.1,4,4
367,5,0,97,11,40.0,7,4
367,6,0,48,4,40.8,3,1
367,7,0,47,8,42.1,4,4
367,8,0,79,10,40.3,5,5
367,9,0,57,8,40.9,5,3
367,10,0,70,9,42.6,7,2
367,11,0,81,12,39.2,7,5
367,12,0,58,9,42.2,8,1
367,13,0,47,7,40.1,3,4
367,14,0,54,10,43.0,7,3
367,15,0,74,12,40.4,7,5
367,16,0,69,11,41.3,6,5
367,17,0,55,8,40.2,2,6
367,18,0,77,13,38.6,8,5
367,19,0,82,12,41.6,8,4
367,20,0,49,8,41.5,2,6
367,21,0,43,7,37.9,4,3
367,22,0,78,14,42.5,8,6
367,23,0,67,12,41.7,8,4
367,24,0,75,14,41.5,11,3
367,25,0,54,14,39.2,9,5
367,26,0,62,15,38.6,10,5
367,27,0,37,9,40.9,5,4
367,28,0,38,10,43.9,7,3
367,29,0,78,17,43.1,10,7
367,30,0,71,15,39.2,11,4
368,1,0,82,11,22.6,7,4
368,2,0,78,5,23.2,3,2
368,3,0,93,9,26.1,4,5
368,4,0,98,9,25.6,6,3
368,5,0,80,12,22.6,7,5
368,6,0,54,6,25.8,3,3
368,7,0,49,5,23.0,3,2
368,8,0,79,11,21.8,9,2
368,9,0,68,8,24.4,4,4
368,10,0,67,9,26.4,5,4
368,11,0,65,7,24.8,2,5
368,12,0,75,12,19.9,9,3
368,13,0,70,9,26.7,7,2
368,14,0,66,15,20.6,6,9
368,15,0,83,12,27.2,8,4
368,16,0,87,13,23.8,10,3
368,17,0,76,11,25.3,8,3
368,18,0,93,16,24.9,7,9
368,19,0,89,14,27.1,7,7
368,20,0,56,8,23.9,4,4
368,21,0,67,10,23.4,6,4
368,22,0,78,14,26.3,7,7
368,23,0,106,19,25.6,8,11
368,24,0,95,16,25.4,8,8
368,25,0,79,18,25.6,11,7
368,26,0,85,17,25.6,5,12
368,27,0,67,16,23.3,6,10
368,28,0,53,11,24.3,6,5
368,29,0,89,18,23.3,10,8
368,30,0,65,14,20.7,2,12
369,1,0,99,8,19.0,3,5
369,2,0,73,7,25.0,5,2
369,3,0,68,6,18.5,6,0
369,4,0,79,7,20.2,5,2
369,5,0,88,9,20.2,6,3
369,6,0,58,7,24.3,5,2
369,7,0,64,9,20.5,9,0
369,8,0,80,9,20.2,7,2
369,9,0,75,10,19.8,7,3
369,10,0,56,7,21.6,5,2
369,11,0,75,10,19.7,3,7
369,12,0,77,11,22.7,7,4
369,13,0,47,6,17.1,4,2
369,14,0,56,10,20.6,7,3
369,15,0,80,12,27.6,10,2
369,16,0,91,13,22.2,7,6
369,17,0,98,16,24.5,12,4
369,18,0,84,13,21.6,11,2
369,19,0,80,14,21.8,11,3
369,20,0,45,9,23.0,7,2
369,21,0,50,8,21.3,7,1
369,22,0,48,8,18.8,7,1
369,23,0,78,13,22.2,7,6
369,24,0,83,17,18.1,11,6
369,25,0,98,19,20.5,14,5
369,26,0,82,16,20.2,10,6
369,27,0,38,13,20.7,9,4
369,28,0,47,11,22.8,6,5
369,29,0,71,13,21.5,8,5
369,30,0,81,17,19.7,13,4
370,1,1,124,29,67.5,16,13
370,2,1,109,24,65.7,15,9
370,3,1,116,27,70.3,10,17
370,4,1,109,29,66.2,11,18
370,5,1,124,35,64.8,18,17
370,6,1,73,21,67.0,9,12
370,7,1,84,24,68.8,9,15
370,8,1,103,33,65.0,20,13
370,9,1,119,40,66.6,19,21
370,10,1,115,42,64.2,20,22
370,11,1,106,37,66.0,19,18
370,12,1,101,38,61.2,21,17
370,13,1,89,34,67.5,15,19
370,14,1,82,32,69.7,20,12
370,15,1,103,43,77.8,17,26
370,16,1,109,49,65.7,28,21
370,17,1,98,43,67.0,23,20
370,18,1,132,61,67.5,23,38
370,19,1,104,52,64.3,25,27
370,20,1,98,51,61.7,31,20
370,21,1,80,39,67.7,15,24
370,22,1,92,47,64.4,18,29
370,23,1,102,54,64.6,30,24
370,24,1,110,58,70.9,42,16
370,25,1,136,73,67.1,42,31
370,26,1,135,74,68.2,39,35
370,27,1,87,48,63.2,24,24
370,28,1,83,49,67.6,23,26
370,29,1,112,66,67.1,33,33
370,30,1,86,53,70.9,30,23
371,1,0,111,8,23.5,4,4
371,2,0,97,10,23.8,6,4
371,3,0,86,9,22.5,4,5
371,4,0,55,7,24.7,3,4
371,5,0,97,10,23.4,7,3
371,6,0,73,7,21.3,2,5
371,7,0,74,10,21.6,7,3
371,8,0,109,11,22.7,7,4
371,9,0,98,12,28.3,5,7
371,10,0,97,14,22.1,5,9
371,11,0,111,15,23.3,9,6
371,12,0,91,14,21.6,6,8
371,13,0,78,11,21.1,3,8
371,14,0,65,11,24.6,5,6
371,15,0,84,12,15.3,7,5
371,16,0,103,19,24.9,7,12
371,17,0,81,11,22.5,5,6
371,18,0,129,20,21.6,10,10
371,19,0,93,16,23.0,11,5
371,20,0,62,10,21.7,5,5
371,21,0,80,14,20.5,7,7
371,22,0,109,17,21.4,11,6
371,23,0,100,18,17.8,7,11
371,24,0,118,22,21.1,11,11
371,25,0,107,20,23.0,13,7
371,26,0,70,13,26.1,8,5
371,27,0,71,15,25.0,8,7
371,28,0,76,14,22.4,8,6
371,29,0,87,22,17.8,9,13
371,30,0,94,21,23.3,5,16
372,1,0,86,6,50.8,4,2
372,2,0,73,5,54.0,2,3
372,3,0,40,3,55.7,1,2
372,4,0,52,7,56.9,5,2
372,5,0,41,4,54.6,1,3
372,6,0,50,6,53.1,5,1
372,7,0,42,4,51.4,1,3
372,8,0,69,8,52.6,6,2
372,9,0,66,9,53.2,7,2
372,10,0,48,9,50.2,2,7
372,11,0,54,7,57.0,3,4
372,12,0,42,8,52.5,5,3
372,13,0,41,8,50.7,5,3
372,14,0,38,5,53.7,3,2
372,15,0,64,11,43.4,5,6
372,16,0,60,9,55.4,5,4
372,17,0,41,5,54.5,2,3
372,18,0,83,12,55.7,5,7
372,19,0,72,10,56.5,5,5
372,20,0,44,8,54.5,4,4
372,21,0,54,9,55.2,5,4
372,22,0,69,14,52.5,10,4
372,23,0,69,11,55.4,4,7
372,24,0,68,11,54.0,5,6
372,25,0,56,9,53.1,3,6
372,26,0,73,16,53.8,9,7
372,27,0,41,8,55.3,3,5
372,28,0,67,14,54.7,11,3
372,29,0,45,9,55.1,7,2
372,30,0,47,11,53.7,8,3
373,1,1,42,10,55.3,4,6
373,2,1,41,9,60.2,5,4
373,3,1,31,12,60.6,6,6
373,4,1,70,17,59.7,6,11
373,5,1,47,14,56.1,6,8
373,6,1,7,2,56.5,1,1
373,7,1,32,10,52.6,6,4
373,8,1,57,19,54.7,10,9
373,9,1,61,21,55.7,14,7
373,10,1,50,20,59.1,6,14
373,11,1,50,19,63.4,10,9
373,12,1,47,20,54.4,6,14
373,13,1,23,12,55.6,6,6
373,14,1,43,21,56.1,9,12
373,15,1,57,23,58.9,10,13
373,16,1,21,8,57.3,4,4
373,17,1,49,20,57.3,14,6
373,18,1,44,22,57.9,13,9
373,19,1,61,30,57.5,14,16
373,20,1,24,13,61.1,6,7
373,21,1,21,13,56.6,8,5
373,22,1,74,42,57.1,20,22
373,23,1,65,37,56.5,19,18
373,24,1,37,25,57.5,11,14
373,25,1,53,31,56.2,12,19
373,26,1,32,19,58.5,12,7
373,27,1,34,22,58.0,8,14
373,28,1,41,24,56.3,11,13
373,29,1,49,30,57.6,14,16
373,30,1,48,30,56.3,16,14
374,1,1,110,24,44.4,12,12
374,2,1,135,34,43.5,19,15
374,3,1,99,27,47.3,11,16
374,4,1,111,31,45.2,16,15
374,5,1,147,40,47.8,18,22
374,6,1,85,26,43.7,12,14
374,7,1,98,29,47.5,16,13
374,8,1,115,36,44.0,14,22
374,9,1,160,55,42.7,25,30
374,10,1,124,45,45.3,29,16
374,11,1,135,54,44.3,27,27
374,12,1,118,43,44.8,21,22
374,13,1,67,27,48.3,9,18
374,14,1,87,33,42.8,14,19
374,15,1,115,48,47.9,28,20
374,16,1,119,54,48.2,26,28
374,17,1,101,47,44.6,26,21
374,18,1,106,47,46.0,30,17
374,19,1,115,54,46.7,33,21
374,20,1,97,49,48.4,17,32
374,21,1,76,36,45.4,18,18
374,22,1,128,63,46.5,30,33
374,23,1,127,65,44.0,32,33
374,24,1,106,56,46.0,26,30
374,25,1,109,61,47.2,24,37
374,26,1,122,69,49.3,39,30
374,27,1,97,55,46.8,31,24
374,28,1,79,48,45.1,25,23
374,29,1,121,71,50.0,33,38
374,30,1,137,84,44.1,35,49
375,1,0,107,9,54.1,5,4
375,2,0,107,11,55.7,6,5
375,3,0,109,11,54.1,6,5
375,4,0,94,9,51.1,4,5
375,5,0,96,9,52.8,5,4
375,6,0,69,8,56.4,2,6
375,7,0,68,8,52.2,3,5
375,8,0,105,11,54.7,5,6
375,9,0,85,9,49.8,1,8
375,10,0,104,13,54.5,5,8
375,11,0,87,11,52.3,5,6
375,12,0,87,11,51.3,8,3
375,13,0,68,8,51.7,6,2
375,14,0,73,10,51.7,5,5
375,15,0,93,13,56.2,8,5
375,16,0,108,16,57.2,9,7
375,17,0,118,17,53.8,9,8
375,18,0,93,14,54.2,8,6
375,19,0,97,15,54.8,8,7
375,20,0,72,13,55.8,6,7
375,21,0,60,12,55.7,6,6
375,22,0,128,23,55.2,11,12
375,23,0,84,16,50.6,7,9
375,24,0,119,23,54.6,10,13
375,25,0,103,20,55.1,9,11
375,26,0,125,23,51.9,7,16
375,27,0,72,13,52.1,5,8
375,28,0,58,14,52.4,9,5
375,29,0,99,19,49.7,10,9
375,30,0,79,17,52.9,8,9
376,1,0,81,5,52.8,1,4
376,2,0,120,9,51.7,5,4
376,3,0,99,10,50.8,6,4
376,4,0,88,8,49.4,5,3
376,5,0,95,10,49.3,3,7
376,6,0,64,6,50.3,3,3
376,7,0,68,11,50.6,5,6
376,8,0,111,12,51.4,8,4
376,9,0,54,8,50.2,3,5
376,10,0,89,10,49.7,6,4
376,11,0,105,16,51.1,8,8
376,12,0,96,15,52.9,4,11
376,13,0,73,10,54.3,7,3
376,14,0,62,9,48.7,5,4
376,15,0,130,21,52.0,13,8
376,16,0,97,16,52.8,9,7
376,17,0,119,19,50.3,9,10
376,18,0,126,20,56.2,9,11
376,19,0,83,15,49.5,9,6
376,20,0,67,11,52.0,6,5
376,21,0,60,14,51.8,11,3
376,22,0,125,21,49.3,10,11
376,23,0,92,17,53.9,7,10
376,24,0,109,20,50.2,9,11
376,25,0,107,20,47.6,12,8
376,26,0,110,23,48.7,11,12
376,27,0,80,16,53.8,10,6
376,28,0,78,15,51.2,11,4
376,29,0,83,18,47.8,5,13
376,30,0,104,23,49.3,7,16
377,1,0,28,2,45.0,2,0
377,2,0,41,4,50.2,2,2
377,3,0,24,2,47.7,1,1
377,4,0,23,5,49.5,3,2
377,5,0,73,9,49.9,5,4
377,6,0,23,3,51.8,2,1
377,7,0,34,3,48.0,3,0
377,8,0,15,3,49.0,0,3
377,9,0,6,1,50.1,0,1
377,10,0,43,4,47.9,4,0
377,11,0,40,6,47.7,1,5
377,12,0,55,11,50.4,7,4
377,13,0,9,1,50.5,1,0
377,14,0,25,5,45.1,3,2
377,15,0,34,4,45.3,0,4
377,16,0,22,7,49.6,5,2
377,17,0,47,8,47.8,5,3
377,18,0,55,9,50.6,7,2
377,19,0,53,9,51.7,4,5
377,20,0,25,9,48.3,4,5
377,21,0,8,2,48.8,1,1
377,22,0,52,13,45.5,9,4
377,23,0,50,9,49.5,6,3
377,24,0,49,8,50.2,6,2
377,25,0,21,8,48.1,5,3
377,26,0,42,7,46.2,5,2
377,27,0,26,7,50.9,4,3
377,28,0,27,8,47.6,6,2
377,29,0,34,10,47.2,5,5
377,30,0,13,2,45.1,2,0
378,1,0,28,4,45.4,1,3
378,2,0,35,3,39.5,3,0
378,3,0,43,4,40.0,3,1
378,4,0,27,4,42.7,2,2
378,5,0,20,4,43.8,1,3
378,6,0,34,4,44.7,2,2
378,7,0,15,3,45.0,3,0
378,8,0,53,10,42.3,9,1
378,9,0,45,6,45.5,2,4
378,10,0,28,3,43.6,3,0
378,11,0,47,5,41.6,4,1
378,12,0,16,1,44.4,1,0
378,13,0,19,5,45.6,2,3
378,14,0,15,1,41.4,1,0
378,15,0,26,3,54.0,2,1
378,16,0,37,6,49.4,4,2
378,17,0,27,6,43.5,4,2
378,18,0,14,8,42.0,5,3
378,19,0,54,10,45.8,9,1
378,20,0,3,1,41.4,1,0
378,21,0,8,3,41.0,2,1
378,22,0,40,8,41.7,7,1
378,23,0,43,10,40.6,7,3
378,24,0,5,5,44.7,2,3
378,25,0,51,9,42.1,5,4
378,26,0,19,5,45.6,2,3
378,27,0,21,7,45.0,4,3
378,28,0,19,4,42.7,3,1
378,29,0,11,3,42.0,2,1
378,30,0,32,7,41.8,4,3
379,1,1,72,15,51.4,6,9
379,2,1,53,15,53.3,6,9
379,3,1,84,22,50.6,4,18
379,4,1,80,25,50.3,17,8
379,5,1,69,21,50.6,10,11
379,6,1,49,18,52.4,10,8
379,7,1,47,15,53.7,7,8
379,8,1,47,15,49.3,5,10
379,9,1,49,16,54.4,9,7
379,10,1,30,14,51.1,4,10
379,11,1,64,23,51.5,12,11
379,12,1,48,19,48.2,9,10
379,13,1,55,21,51.4,17,4
379,14,1,32,15,50.2,8,7
379,15,1,67,26,47.1,13,13
379,16,1,65,27,50.1,7,20
379,17,1,67,31,51.2,19,12
379,18,1,60,26,50.5,13,13
379,19,1,67,32,49.4,20,12
379,20,1,45,22,49.5,12,10
379,21,1,50,25,53.3,11,14
379,22,1,71,37,49.3,21,16
379,23,1,56,29,53.1,14,15
379,24,1,73,38,54.1,19,19
379,25,1,93,51,51.4,29,22
379,26,1,94,52,52.2,25,27
379,27,1,35,21,49.6,8,13
379,28,1,34,20,49.8,14,6
379,29,1,67,40,48.4,17,23
379,30,1,47,33,50.6,19,14
380,1,0,33,3,78.3,1,2
380,2,0,42,7,76.9,3,4
380,3,0,22,2,76.0,0,2
380,4,0,66,8,77.0,4,4
380,5,0,62,6,73.0,3,3
380,6,0,22,3,74.1,1,2
380,7,0,28,6,78.8,3,3
380,8,0,41,6,75.8,2,4
380,9,0,74,9,73.7,3,6
380,10,0,45,6,74.4,2,4
380,11,0,39,6,74.2,1,5
380,12,0,62,10,76.5,4,6
380,13,0,32,6,78.4,2,4
380,14,0,46,9,74.7,3,6
380,15,0,38,8,81.1,4,4
380,16,0,20,3,76.4,2,1
380,17,0,46,7,73.0,4,3
380,18,0,59,10,76.6,5,5
380,19,0,50,10,76.4,1,9
380,20,0,25,5,74.6,1,4
380,21,0,36,6,76.4,2,4
380,22,0,46,7,77.0,4,3
380,23,0,68,16,77.8,7,9
380,24,0,33,5,76.6,3,2
380,25,0,31,6,73.1,1,5
380,26,0,64,18,76.2,8,10
380,27,0,38,10,74.3,4,6
380,28,0,40,8,75.1,5,3
380,29,0,52,14,75.8,5,9
380,30,0,35,10,72.5,2,8
381,1,0,56,4,27.7,0,4
381,2,0,78,7,29.5,4,3
381,3,0,53,5,25.7,3,2
381,4,0,61,6,29.0,4,2
381,5,0,31,4,26.6,0,4
381,6,0,36,5,28.3,4,1
381,7,0,20,4,25.7,2,2
381,8,0,55,7,26.8,5,2
381,9,0,70,8,24.7,0,8
381,10,0,70,8,25.4,4,4
381,11,0,47,8,28.2,2,6
381,12,0,46,5,26.1,2,3
381,13,0,48,6,24.8,2,4
381,14,0,32,6,29.4,2,4
381,15,0,62,9,28.5,4,5
381,16,0,43,9,26.6,4,5
381,17,0,48,8,27.7,6,2
381,18,0,35,5,26.8,2,3
381,19,0,65,11,30.0,9,2
381,20,0,27,7,26.9,3,4
381,21,0,23,8,28.2,4,4
381,22,0,63,12,25.6,3,9
381,23,0,75,13,27.0,6,7
381,24,0,53,9,27.8,5,4
381,25,0,64,12,23.7,7,5
381,26,0,45,9,28.3,1,8
381,27,0,23,5,26.9,4,1
381,28,0,35,8,28.4,4,4
381,29,0,61,13,28.4,8,5
381,30,0,59,13,27.5,6,7
382,1,0,72,6,54.7,4,2
382,2,0,49,6,59.3,6,0
382,3,0,68,7,57.4,5,2
382,4,0,69,7,57.7,5,2
382,5,0,54,4,56.7,2,2
382,6,0,66,7,57.3,6,1
382,7,0,34,6,56.6,2,4
382,8,0,74,8,56.9,5,3
382,9,0,44,8,60.4,2,6
382,10,0,43,7,57.2,5,2
382,11,0,89,12,57.4,6,6
382,12,0,59,9,55.6,6,3
382,13,0,34,7,56.4,6,1
382,14,0,24,7,56.6,4,3
382,15,0,37,7,43.8,4,3
382,16,0,60,10,58.9,4,6
382,17,0,44,12,55.1,8,4
382,18,0,94,16,56.6,10,6
382,19,0,72,11,56.9,8,3
382,20,0,30,5,56.2,3,2
382,21,0,44,9,58.1,5,4
382,22,0,47,8,57.3,5,3
382,23,0,80,13,60.6,6,7
382,24,0,70,12,57.4,7,5
382,25,0,66,14,57.0,8,6
382,26,0,78,16,54.7,11,5
382,27,0,51,11,59.1,9,2
382,28,0,38,10,54.1,9,1
382,29,0,49,10,52.7,9,1
382,30,0,64,13,59.0,12,1
383,1,0,66,6,24.4,2,4
383,2,0,78,9,23.2,1,8
383,3,0,55,8,32.5,5,3
383,4,0,78,8,26.0,1,7
383,5,0,68,6,26.7,2,4
383,6,0,34,9,25.2,3,6
383,7,0,46,6,27.9,1,5
383,8,0,78,8,24.5,2,6
383,9,0,53,6,23.3,2,4
383,10,0,53,6,27.8,2,4
383,11,0,78,14,28.6,6,8
383,12,0,41,4,27.6,0,4
383,13,0,54,8,26.4,2,6
383,14,0,59,9,23.7,4,5
383,15,0,75,10,27.6,3,7
383,16,0,92,12,27.9,7,5
383,17,0,47,8,27.5,3,5
383,18,0,66,10,22.2,3,7
383,19,0,53,10,27.6,4,6
383,20,0,42,7,25.9,1,6
383,21,0,59,12,25.8,1,11
383,22,0,39,8,29.7,2,6
383,23,0,63,12,23.2,5,7
383,24,0,62,12,27.9,5,7
383,25,0,93,18,27.3,5,13
383,26,0,67,12,28.3,5,7
383,27,0,44,12,26.7,5,7
383,28,0,59,11,24.5,8,3
383,29,0,44,10,23.7,5,5
383,30,0,77,17,24.1,5,12
384,1,1,36,9,26.7,1,8
384,2,1,51,11,24.1,3,8
384,3,1,34,10,23.5,4,6
384,4,1,47,14,25.8,6,8
384,5,1,65,18,23.4,11,7
384,6,1,49,16,25.9,7,9
384,7,1,29,10,25.8,5,5
384,8,1,63,21,23.9,9,12
384,9,1,66,23,22.8,10,13
384,10,1,62,20,28.3,8,12
384,11,1,51,24,24.0,17,7
384,12,1,56,23,25.6,12,11
384,13,1,45,19,25.6,10,9
384,14,1,42,20,24.0,11,9
384,15,1,59,23,27.8,12,11
384,16,1,45,18,22.1,7,11
384,17,1,57,24,26.9,12,12
384,18,1,44,21,21.6,11,10
384,19,1,62,30,20.4,18,12
384,20,1,52,25,26.2,11,14
384,21,1,23,13,22.4,10,3
384,22,1,79,40,23.3,21,19
384,23,1,53,29,28.2,16,13
384,24,1,43,25,22.8,9,16
384,25,1,42,22,22.3,8,14
384,26,1,58,32,25.3,13,19
384,27,1,37,24,25.6,7,17
384,28,1,41,25,22.9,14,11
384,29,1,42,25,24.8,14,11
384,30,1,66,41,27.9,27,14
385,1,0,79,7,39.3,4,3
385,2,0,61,4,42.2,3,1
385,3,0,66,7,35.7,5,2
385,4,0,95,9,36.2,6,3
385,5,0,33,3,36.2,2,1
385,6,0,47,7,42.1,3,4
385,7,0,43,8,40.7,6,2
385,8,0,68,6,37.8,4,2
385,9,0,78,12,37.7,7,5
385,10,0,84,9,39.7,7,2
385,11,0,79,12,39.8,8,4
385,12,0,78,11,37.7,9,2
385,13,0,32,5,36.2,2,3
385,14,0,58,8,39.3,5,3
385,15,0,67,10,34.7,6,4
385,16,0,50,6,41.5,5,1
385,17,0,90,14,38.9,7,7
385,18,0,74,11,41.5,9,2
385,19,0,61,13,36.9,9,4
385,20,0,58,10,39.8,9,1
385,21,0,56,11,40.0,5,6
385,22,0,72,14,38.7,7,7
385,23,0,46,8,35.8,7,1
385,24,0,64,13,38.7,9,4
385,25,0,83,17,38.4,11,6
385,26,0,98,23,39.5,15,8
385,27,0,63,15,39.6,7,8
385,28,0,47,11,41.5,7,4
385,29,0,79,17,39.0,12,5
385,30,0,71,16,42.3,11,5
386,1,1,71,16,49.1,7,9
386,2,1,85,21,44.8,11,10
386,3,1,105,26,50.1,10,16
386,4,1,66,19,49.5,5,14
386,5,1,76,22,43.6,12,10
386,6,1,66,20,46.3,10,10
386,7,1,63,20,47.5,4,16
386,8,1,86,27,48.6,12,15
386,9,1,94,32,44.5,19,13
386,10,1,91,32,47.5,16,16
386,11,1,84,33,50.3,15,18
386,12,1,92,35,49.6,16,19
386,13,1,59,26,50.8,15,11
386,14,1,57,26,49.0,8,18
386,15,1,75,34,48.2,18,16
386,16,1,66,29,46.4,8,21
386,17,1,82,35,45.9,14,21
386,18,1,93,42,46.4,15,27
386,19,1,95,45,48.3,26,19
386,20,1,63,35,48.5,16,19
386,21,1,61,32,49.6,13,19
386,22,1,116,57,47.6,29,28
386,23,1,66,36,48.2,22,14
386,24,1,57,31,48.9,14,17
386,25,1,80,43,47.4,24,19
386,26,1,88,50,47.9,23,27
386,27,1,82,47,44.2,19,28
386,28,1,58,38,47.8,26,12
386,29,1,91,55,52.9,32,23
386,30,1,123,75,48.5,24,51
387,1,0,93,9,53.1,5,4
387,2,0,135,11,55.0,5,6
387,3,0,81,6,56.4,4,2
387,4,0,105,11,54.6,5,6
387,5,0,114,11,53.7,5,6
387,6,0,95,10,54.6,2,8
387,7,0,100,14,53.6,3,11
387,8,0,122,13,53.9,3,10
387,9,0,117,13,54.4,6,7
387,10,0,123,15,52.6,6,9
387,11,0,105,13,56.4,3,10
387,12,0,105,15,55.3,4,11
387,13,0,89,13,54.1,5,8
387,14,0,73,12,54.7,3,9
387,15,0,132,19,66.8,8,11
387,16,0,130,20,53.2,4,16
387,17,0,101,17,51.9,6,11
387,18,0,128,20,55.8,7,13
387,19,0,108,19,52.4,6,13
387,20,0,84,18,55.9,7,11
387,21,0,82,16,54.8,5,11
387,22,0,116,20,54.1,5,15
387,23,0,98,17,57.6,4,13
387,24,0,132,23,52.6,8,15
387,25,0,151,28,52.6,8,20
387,26,0,104,19,54.6,8,11
387,27,0,83,16,53.6,7,9
387,28,0,84,20,51.7,6,14
387,29,0,121,24,55.9,6,18
387,30,0,134,28,55.0,6,22
388,1,0,85,8,77.9,5,3
388,2,0,86,7,78.0,5,2
388,3,0,73,9,77.1,6,3
388,4,0,81,8,78.1,4,4
388,5,0,94,8,77.8,5,3
388,6,0,51,7,78.2,4,3
388,7,0,59,6,79.0,5,1
388,8,0,84,11,81.4,4,7
388,9,0,92,12,75.9,5,7
388,10,0,87,11,73.6,7,4
388,11,0,96,12,76.4,7,5
388,12,0,98,13,75.6,7,6
388,13,0,51,7,73.5,4,3
388,14,0,71,12,78.7,5,7
388,15,0,65,12,77.4,8,4
388,16,0,100,13,76.2,6,7
388,17,0,87,13,78.2,8,5
388,18,0,61,11,75.5,1,10
388,19,0,85,14,73.7,7,7
388,20,0,58,10,78.5,5,5
388,21,0,49,9,79.2,7,2
388,22,0,97,17,75.5,10,7
388,23,0,66,11,77.5,6,5
388,24,0,92,15,72.6,7,8
388,25,0,84,15,77.0,8,7
388,26,0,72,15,78.8,8,7
388,27,0,55,13,74.1,9,4
388,28,0,84,17,76.7,11,6
388,29,0,92,20,78.1,11,9
388,30,0,89,18,75.7,8,10
389,1,0,73,7,59.9,4,3
389,2,0,42,6,57.0,2,4
389,3,0,71,8,51.7,0,8
389,4,0,78,6,56.5,1,5
389,5,0,68,7,58.1,3,4
389,6,0,73,8,55.7,2,6
389,7,0,68,8,59.1,1,7
389,8,0,110,12,56.7,3,9
389,9,0,55,6,56.4,1,5
389,10,0,62,6,58.8,1,5
389,11,0,94,13,58.7,8,5
389,12,0,83,11,58.0,3,8
389,13,0,34,4,53.6,2,2
389,14,0,52,9,54.6,4,5
389,15,0,107,14,58.3,3,11
389,16,0,86,12,56.7,5,7
389,17,0,70,10,53.4,4,6
389,18,0,85,14,58.1,4,10
389,19,0,88,15,58.2,2,13
389,20,0,43,9,55.9,3,6
389,21,0,50,12,56.1,5,7
389,22,0,83,15,58.5,8,7
389,23,0,80,17,59.2,2,15
389,24,0,79,15,59.7,4,11
389,25,0,80,15,55.7,7,8
389,26,0,89,17,60.5,7,10
389,27,0,70,15,56.5,2,13
389,28,0,64,13,57.5,6,7
389,29,0,89,21,59.8,11,10
389,30,0,80,16,54.4,8,8
390,1,0,92,8,58.8,7,1
390,2,0,121,12,61.3,6,6
390,3,0,93,10,58.4,6,4
390,4,0,119,12,61.9,11,1
390,5,0,86,8,62.8,5,3
390,6,0,67,11,64.8,4,7
390,7,0,50,8,62.0,4,4
390,8,0,103,11,62.8,7,4
390,9,0,104,12,64.2,5,7
390,10,0,104,12,62.1,5,7
390,11,0,86,11,64.5,7,4
390,12,0,91,10,60.5,8,2
390,13,0,65,9,64.3,5,4
390,14,0,77,11,63.0,7,4
390,15,0,110,15,58.2,13,2
390,16,0,99,15,61.3,8,7
390,17,0,85,13,62.2,9,4
390,18,0,120,22,58.6,15,7
390,19,0,122,19,63.5,8,11
390,20,0,73,12,62.3,9,3
390,21,0,60,11,64.4,9,2
390,22,0,106,17,61.0,12,5
390,23,0,100,18,60.6,11,7
390,24,0,106,20,64.2,13,7
390,25,0,131,24,61.4,15,9
390,26,0,121,25,62.4,14,11
390,27,0,64,11,65.8,10,1
390,28,0,82,19,64.6,14,5
390,29,0,105,22,62.0,14,8
390,30,0,124,26,63.9,11,15
391,1,0,93,6,70.1,4,2
391,2,0,71,6,66.3,2,4
391,3,0,48,3,65.0,1,2
391,4,0,62,8,65.9,5,3
391,5,0,50,6,69.4,5,1
391,6,0,58,7,65.5,4,3
391,7,0,39,4,67.2,1,3
391,8,0,46,7,63.9,6,1
391,9,0,64,9,66.8,6,3
391,10,0,86,10,66.4,9,1
391,11,0,48,6,65.6,4,2
391,12,0,82,11,62.1,8,3
391,13,0,54,9,66.1,3,6
391,14,0,64,8,64.6,4,4
391,15,0,90,13,66.1,12,1
391,16,0,74,11,63.1,8,3
391,17,0,73,11,69.0,8,3
391,18,0,85,15,69.5,11,4
391,19,0,74,13,68.1,11,2
391,20,0,74,12,66.8,6,6
391,21,0,50,9,64.0,7,2
391,22,0,48,8,62.6,4,4
391,23,0,54,12,61.7,7,5
391,24,0,76,18,65.9,9,9
391,25,0,98,20,68.0,10,10
391,26,0,83,17,64.3,11,6
391,27,0,44,10,63.2,9,1
391,28,0,55,12,63.2,8,4
391,29,0,85,18,65.3,10,8
391,30,0,102,22,69.1,19,3
392,1,0,25,1,33.4,1,0
392,2,0,36,6,32.0,2,4
392,3,0,12,3,32.9,1,2
392,4,0,58,7,33.5,3,4
392,5,0,78,6,32.1,3,3
392,6,0,37,8,31.8,4,4
392,7,0,40,9,35.3,6,3
392,8,0,35,5,31.6,2,3
392,9,0,44,7,32.2,3,4
392,10,0,60,7,32.4,2,5
392,11,0,63,9,33.7,1,8
392,12,0,47,5,35.6,2,3
392,13,0,32,5,33.1,3,2
392,14,0,46,7,32.9,5,2
392,15,0,47,11,37.9,7,4
392,16,0,56,8,30.6,2,6
392,17,0,44,7,32.7,4,3
392,18,0,37,7,32.9,3,4
392,19,0,61,10,32.6,6,4
392,20,0,40,9,32.0,2,7
392,21,0,20,5,31.2,2,3
392,22,0,52,9,31.5,7,2
392,23,0,55,9,31.4,6,3
392,24,0,43,11,31.5,8,3
392,25,0,52,12,33.8,5,7
392,26,0,45,8,30.3,3,5
392,27,0,47,12,34.5,6,6
392,28,0,24,4,30.6,2,2
392,29,0,50,9,32.8,4,5
392,30,0,62,16,32.3,7,9
393,1,0,56,5,63.6,2,3
393,2,0,56,6,67.8,3,3
393,3,0,73,9,62.1,1,8
393,4,0,44,5,63.2,2,3
393,5,0,75,6,64.5,1,5
393,6,0,44,4,70.1,2,2
393,7,0,49,5,62.4,4,1
393,8,0,41,9,68.8,7,2
393,9,0,65,9,65.8,5,4
393,10,0,35,6,65.4,2,4
393,11,0,29,7,63.3,3,4
393,12,0,45,5,65.2,1,4
393,13,0,28,4,66.0,1,3
393,14,0,23,3,68.0,2,1
393,15,0,33,7,60.3,5,2
393,16,0,57,8,62.0,2,6
393,17,0,35,8,64.5,5,3
393,18,0,64,12,65.6,3,9
393,19,0,66,11,63.0,0,11
393,20,0,28,6,59.9,1,5
393,21,0,39,6,64.4,2,4
393,22,0,23,4,63.5,0,4
393,23,0,89,16,65.4,6,10
393,24,0,69,15,63.2,8,7
393,25,0,75,19,62.6,8,11
393,26,0,62,13,66.7,3,10
393,27,0,51,10,65.1,3,7
393,28,0,42,9,64.9,6,3
393,29,0,50,15,64.8,5,10
393,30,0,59,13,62.9,6,7
394,1,1,106,25,74.2,15,10
394,2,1,109,26,74.2,15,11
394,3,1,109,27,74.8,16,11
394,4,1,103,27,70.9,19,8
394,5,1,128,35,72.5,21,14
394,6,1,76,22,74.9,6,16
394,7,1,78,26,71.2,12,14
394,8,1,101,32,70.1,18,14
394,9,1,108,34,72.7,16,18
394,10,1,144,47,70.5,21,26
394,11,1,125,45,70.1,22,23
394,12,1,106,42,69.4,29,13
394,13,1,78,32,70.9,12,20
394,14,1,81,33,71.2,8,25
394,15,1,80,33,74.7,14,19
394,16,1,127,53,66.2,27,26
394,17,1,118,54,75.9,32,22
394,18,1,93,43,75.5,23,20
394,19,1,125,61,71.1,27,34
394,20,1,96,48,71.7,20,28
394,21,1,80,41,66.8,22,19
394,22,1,101,50,76.4,22,28
394,23,1,114,59,73.8,26,33
394,24,1,137,75,69.6,31,44
394,25,1,95,54,67.7,22,32
394,26,1,121,66,72.8,30,36
394,27,1,81,47,71.7,22,25
394,28,1,89,53,72.9,25,28
394,29,1,92,56,72.8,30,26
394,30,1,101,61,75.1,29,32
395,1,0,105,9,34.2,2,7
395,2,0,108,14,38.5,6,8
395,3,0,97,7,38.4,3,4
395,4,0,105,10,38.2,9,1
395,5,0,114,10,33.1,4,6
395,6,0,68,8,32.9,5,3
395,7,0,63,9,33.8,4,5
395,8,0,84,11,34.9,6,5
395,9,0,125,17,33.7,7,10
395,10,0,96,10,31.3,5,5
395,11,0,96,15,33.5,9,6
395,12,0,92,13,33.3,8,5
395,13,0,93,15,35.0,5,10
395,14,0,76,11,39.5,5,6
395,15,0,89,11,36.6,8,3
395,16,0,98,14,36.4,7,7
395,17,0,120,19,37.4,11,8
395,18,0,101,17,35.9,10,7
395,19,0,99,15,35.9,7,8
395,20,0,55,11,34.4,4,7
395,21,0,87,16,35.1,10,6
395,22,0,118,19,34.5,10,9
395,23,0,115,20,36.7,14,6
395,24,0,114,19,30.5,14,5
395,25,0,96,18,36.6,6,12
395,26,0,86,16,38.0,8,8
395,27,0,77,14,36.0,8,6
395,28,0,75,16,36.4,5,11
395,29,0,110,22,31.1,11,11
395,30,0,105,23,35.0,10,13
396,1,0,0,2,73.4,2,0
396,2,0,35,5,77.3,4,1
396,3,0,0,1,78.6,1,0
396,4,0,19,3,78.1,2,1
396,5,0,26,5,77.6,3,2
396,6,0,28,3,74.3,2,1
396,7,0,29,2,74.7,2,0
396,8,0,8,0,76.9,0,0
396,9,0,3,1,74.9,1,0
396,10,0,8,1,76.8,1,0
396,11,0,25,3,79.6,2,1
396,12,0,0,2,74.3,0,2
396,13,0,2,3,75.2,3,0
396,14,0,28,5,79.7,2,3
396,15,0,24,6,68.5,3,3
396,16,0,44,8,79.4,7,1
396,17,0,33,5,76.3,3,2
396,18,0,20,8,78.1,5,3
396,19,0,15,4,74.7,2,2
396,20,0,4,4,78.1,1,3
396,21,0,18,4,79.9,3,1
396,22,0,40,8,74.6,3,5
396,23,0,13,3,74.2,1,2
396,24,0,18,6,75.6,4,2
396,25,0,23,9,76.1,6,3
396,26,0,35,8,74.1,6,2
396,27,0,7,2,76.2,2,0
396,28,0,0,1,74.8,1,0
396,29,0,26,7,79.0,6,1
396,30,0,8,2,81.1,2,0
397,1,0,66,4,38.4,3,1
397,2,0,73,6,41.7,4,2
397,3,0,88,9,39.7,5,4
397,4,0,90,9,34.0,6,3
397,5,0,81,11,37.5,9,2
397,6,0,50,7,37.1,7,0
397,7,0,58,6,35.9,4,2
397,8,0,77,8,35.7,6,2
397,9,0,67,8,38.1,6,2
397,10,0,85,12,34.4,9,3
397,11,0,102,13,36.5,8,5
397,12,0,92,15,38.1,10,5
397,13,0,53,11,37.4,7,4
397,14,0,75,10,35.1,7,3
397,15,0,65,13,31.2,8,5
397,16,0,68,13,39.2,9,4
397,17,0,64,12,38.4,11,1
397,18,0,101,15,36.4,8,7
397,19,0,73,14,35.5,9,5
397,20,0,60,12,37.9,5,7
397,21,0,67,12,37.8,9,3
397,22,0,83,13,36.9,9,4
397,23,0,56,10,37.3,7,3
397,24,0,106,23,35.2,17,6
397,25,0,86,15,38.0,12,3
397,26,0,83,19,37.1,14,5
397,27,0,56,14,38.8,7,7
397,28,0,63,13,36.1,7,6
397,29,0,102,22,35.9,13,9
397,30,0,108,22,36.2,18,4
398,1,1,24,6,66.2,1,5
398,2,1,30,9,62.6,6,3
398,3,1,15,4,60.8,2,2
398,4,1,32,9,61.1,4,5
398,5,1,48,13,63.6,9,4
398,6,1,13,5,67.8,2,3
398,7,1,11,5,65.2,3,2
398,8,1,24,8,64.0,4,4
398,9,1,20,8,66.7,6,2
398,10,1,13,6,65.2,4,2
398,11,1,20,8,65.4,5,3
398,12,1,38,14,65.4,9,5
398,13,1,30,12,65.6,7,5
398,14,1,36,17,64.9,7,10
398,15,1,31,17,72.1,10,7
398,16,1,40,16,62.7,4,12
398,17,1,11,6,61.9,4,2
398,18,1,40,20,64.2,9,11
398,19,1,65,32,66.6,12,20
398,20,1,5,4,63.7,3,1
398,21,1,5,4,65.9,1,3
398,22,1,29,14,64.2,3,11
398,23,1,64,32,64.9,15,17
398,24,1,6,5,65.2,1,4
398,25,1,36,23,63.4,15,8
398,26,1,60,37,62.3,14,23
398,27,1,11,8,67.5,2,6
398,28,1,22,15,66.1,8,7
398,29,1,24,15,65.6,8,7
398,30,1,24,16,61.6,6,10
399,1,1,106,23,22.8,11,12
399,2,1,80,22,29.7,15,7
399,3,1,53,12,25.5,2,10
399,4,1,83,22,24.5,12,10
399,5,1,88,26,28.5,17,9
399,6,1,52,16,20.1,5,11
399,7,1,60,18,25.0,7,11
399,8,1,62,23,23.7,10,13
399,9,1,63,20,24.9,9,11
399,10,1,66,23,23.9,11,12
399,11,1,55,20,23.9,7,13
399,12,1,100,38,21.6,17,21
399,13,1,46,18,22.9,7,11
399,14,1,59,25,27.8,17,8
399,15,1,98,41,30.6,22,19
399,16,1,94,43,25.0,21,22
399,17,1,88,39,24.2,21,18
399,18,1,87,40,23.6,17,23
399,19,1,51,24,25.2,14,10
399,20,1,56,30,23.0,15,15
399,21,1,62,31,25.6,17,14
399,22,1,106,55,24.0,25,30
399,23,1,73,39,24.6,24,15
399,24,1,77,41,25.5,21,20
399,25,1,84,45,22.6,20,25
399,26,1,81,47,26.3,20,27
399,27,1,56,33,23.5,13,20
399,28,1,59,34,20.6,16,18
399,29,1,71,42,22.7,17,25
399,30,1,106,65,25.3,30,35
400,1,0,111,9,63.8,8,1
400,2,0,109,11,60.4,7,4
400,3,0,105,10,57.5,8,2
400,4,0,98,9,65.9,8,1
400,5,0,117,10,62.7,8,2
400,6,0,49,6,61.4,6,0
400,7,0,82,11,58.5,6,5
400,8,0,77,10,62.0,6,4
400,9,0,94,12,59.0,7,5
400,10,0,103,11,59.2,7,4
400,11,0,100,15,55.4,9,6
400,12,0,107,13,58.4,11,2
400,13,0,76,11,61.0,9,2
400,14,0,66,11,60.3,4,7
400,15,0,105,17,54.6,7,10
400,16,0,87,14,60.3,10,4
400,17,0,99,16,61.7,12,4
400,18,0,114,18,62.6,10,8
400,19,0,84,14,61.1,10,4
400,20,0,53,8,61.5,4,4
400,21,0,77,14,59.3,7,7
400,22,0,103,19,60.3,12,7
400,23,0,112,23,60.2,11,12
400,24,0,123,23,56.4,16,7
400,25,0,65,12,59.1,6,6
400,26,0,114,24,59.1,14,10
400,27,0,75,15,59.1,8,7
400,28,0,82,15,60.3,7,8
400,29,0,99,22,61.9,14,8
400,30,0,75,19,61.1,9,10
401,1,0,19,4,36.2,2,2
401,2,0,53,6,36.9,3,3
401,3,0,37,7,38.4,3,4
401,4,0,28,2,38.4,0,2
401,5,0,62,6,39.1,4,2
401,6,0,21,3,35.7,0,3
401,7,0,27,2,34.9,0,2
401,8,0,33,5,35.9,2,3
401,9,0,27,2,35.6,0,2
401,10,0,43,4,34.0,2,2
401,11,0,8,0,33.1,0,0
401,12,0,28,6,36.5,3,3
401,13,0,24,3,35.9,1,2
401,14,0,40,6,36.5,3,3
401,15,0,63,9,38.1,2,7
401,16,0,40,7,40.0,3,4
401,17,0,31,4,36.1,1,3
401,18,0,5,3,35.7,1,2
401,19,0,42,7,39.8,4,3
401,20,0,20,5,34.0,2,3
401,21,0,26,5,32.9,2,3
401,22,0,18,3,35.6,0,3
401,23,0,43,10,35.6,3,7
401,24,0,63,12,35.0,6,6
401,25,0,54,9,33.3,1,8
401,26,0,57,10,35.4,3,7
401,27,0,25,5,32.6,2,3
401,28,0,20,4,34.7,2,2
401,29,0,43,8,35.5,3,5
401,30,0,27,6,38.5,4,2
402,1,0,131,11,58.6,10,1
402,2,0,104,7,55.0,3,4
402,3,0,108,9,54.8,5,4
402,4,0,108,10,57.6,5,5
402,5,0,100,10,55.1,7,3
402,6,0,61,8,55.0,6,2
402,7,0,80,8,56.7,6,2
402,8,0,109,13,55.6,8,5
402,9,0,112,13,54.4,7,6
402,10,0,92,13,53.6,8,5
402,11,0,103,14,56.6,8,6
402,12,0,82,14,57.0,10,4
402,13,0,77,12,55.8,8,4
402,14,0,65,11,57.1,8,3
402,15,0,87,14,58.9,10,4
402,16,0,110,16,52.7,15,1
402,17,0,99,17,57.2,13,4
402,18,0,100,16,57.4,12,4
402,19,0,83,15,58.5,9,6
402,20,0,80,13,57.5,9,4
402,21,0,64,11,53.0,9,2
402,22,0,108,21,55.8,17,4
402,23,0,99,21,53.9,15,6
402,24,0,94,19,54.8,10,9
402,25,0,94,19,55.7,11,8
402,26,0,104,21,56.7,19,2
402,27,0,73,15,57.4,12,3
402,28,0,61,12,57.6,10,2
402,29,0,70,15,52.1,10,5
402,30,0,129,26,56.3,21,5
403,1,0,89,6,26.3,1,5
403,2,0,66,7,28.6,3,4
403,3,0,93,9,26.7,6,3
403,4,0,36,5,26.1,0,5
403,5,0,75,8,26.0,2,6
403,6,0,40,5,24.7,1,4
403,7,0,45,5,27.9,1,4
403,8,0,90,12,25.1,4,8
403,9,0,72,9,26.3,3,6
403,10,0,72,10,27.3,1,9
403,11,0,87,11,25.1,4,7
403,12,0,116,19,29.7,10,9
403,13,0,70,8,26.2,2,6
403,14,0,65,9,22.9,3,6
403,15,0,86,13,15.9,3,10
403,16,0,104,16,24.9,6,10
403,17,0,85,14,27.1,1,13
403,18,0,108,17,28.7,10,7
403,19,0,78,13,29.6,2,11
403,20,0,82,16,26.6,5,11
403,21,0,60,13,26.2,6,7
403,22,0,87,18,26.0,7,11
403,23,0,68,14,24.3,5,9
403,24,0,77,16,29.6,4,12
403,25,0,94,18,25.3,2,16
403,26,0,90,18,26.4,6,12
403,27,0,48,10,26.9,5,5
403,28,0,63,13,29.6,4,9
403,29,0,88,21,23.8,7,14
403,30,0,73,16,29.0,6,10
404,1,0,74,6,38.8,2,4
404,2,0,81,7,44.2,4,3
404,3,0,99,11,41.9,3,8
404,4,0,73,6,41.6,3,3
404,5,0,76,9,45.0,4,5
404,6,0,62,5,42.3,2,3
404,7,0,74,9,44.9,5,4
404,8,0,105,10,42.6,0,10
404,9,0,112,17,44.9,11,6
404,10,0,100,13,41.4,8,5
404,11,0,100,15,43.8,11,4
404,12,0,108,13,44.8,6,7
404,13,0,78,10,42.4,5,5
404,14,0,66,9,43.7,5,4
404,15,0,90,12,40.8,6,6
404,16,0,90,14,42.5,4,10
404,17,0,85,13,44.8,7,6
404,18,0,76,13,43.8,7,6
404,19,0,120,21,48.9,12,9
404,20,0,73,14,43.6,5,9
404,21,0,71,14,41.9,6,8
404,22,0,115,19,43.7,7,12
404,23,0,95,25,42.9,16,9
404,24,0,93,19,43.7,11,8
404,25,0,54,11,38.8,9,2
404,26,0,121,25,43.4,10,15
404,27,0,60,13,40.6,9,4
404,28,0,76,18,44.0,10,8
404,29,0,99,19,41.4,6,13
404,30,0,87,18,45.3,12,6
405,1,0,91,11,57.8,9,2
405,2,0,91,7,58.7,3,4
405,3,0,71,6,57.3,5,1
405,4,0,88,8,58.0,4,4
405,5,0,97,11,57.7,8,3
405,6,0,54,5,57.3,4,1
405,7,0,75,8,53.9,4,4
405,8,0,95,11,57.8,7,4
405,9,0,103,10,59.0,10,0
405,10,0,113,14,58.0,10,4
405,11,0,77,11,55.8,9,2
405,12,0,81,11,59.1,5,6
405,13,0,61,10,57.9,7,3
405,14,0,90,11,59.7,6,5
405,15,0,100,15,55.5,11,4
405,16,0,70,10,61.1,6,4
405,17,0,103,17,60.6,10,7
405,18,0,93,13,55.5,7,6
405,19,0,73,13,57.3,8,5
405,20,0,66,13,57.6,7,6
405,21,0,75,15,59.7,9,6
405,22,0,89,16,61.7,10,6
405,23,0,114,21,58.1,15,6
405,24,0,126,22,58.2,13,9
405,25,0,107,19,62.5,12,7
405,26,0,105,20,60.2,12,8
405,27,0,75,15,59.4,10,5
405,28,0,57,10,59.9,6,4
405,29,0,111,23,62.4,16,7
405,30,0,106,22,56.6,14,8
406,1,0,10,0,55.0,0,0
406,2,0,14,4,58.5,3,1
406,3,0,33,4,55.5,3,1
406,4,0,0,0,57.1,0,0
406,5,0,34,5,54.5,4,1
406,6,0,11,2,53.7,1,1
406,7,0,16,2,54.8,2,0
406,8,0,37,7,55.1,5,2
406,9,0,0,3,54.7,2,1
406,10,0,16,3,57.3,1,2
406,11,0,21,5,57.7,5,0
406,12,0,37,6,54.2,3,3
406,13,0,24,3,53.4,2,1
406,14,0,16,3,56.2,1,2
406,15,0,22,2,55.5,2,0
406,16,0,9,4,51.5,3,1
406,17,0,46,9,57.4,8,1
406,18,0,8,3,58.1,2,1
406,19,0,17,6,54.1,6,0
406,20,0,5,0,54.1,0,0
406,21,0,5,3,54.6,2,1
406,22,0,0,1,56.6,1,0
406,23,0,5,3,54.8,1,2
406,24,0,6,3,58.2,2,1
406,25,0,28,6,55.2,5,1
406,26,0,1,2,56.6,0,2
406,27,0,15,5,56.8,3,2
406,28,0,5,1,59.7,0,1
406,29,0,0,1,54.5,1,0
406,30,0,55,14,56.4,7,7
407,1,0,83,7,32.9,2,5
407,2,0,110,11,37.4,5,6
407,3,0,94,8,39.6,6,2
407,4,0,96,12,35.9,6,6
407,5,0,99,10,39.2,7,3
407,6,0,63,5,38.2,3,2
407,7,0,65,6,35.7,4,2
407,8,0,87,13,36.7,8,5
407,9,0,81,12,34.7,5,7
407,10,0,103,13,32.3,7,6
407,11,0,83,10,35.6,5,5
407,12,0,103,15,34.7,8,7
407,13,0,71,10,34.0,7,3
407,14,0,68,10,36.0,4,6
407,15,0,96,16,35.7,5,11
407,16,0,114,16,34.0,10,6
407,17,0,53,12,38.3,5,7
407,18,0,125,22,35.2,14,8
407,19,0,82,14,30.4,6,8
407,20,0,76,16,35.6,5,11
407,21,0,68,12,35.8,8,4
407,22,0,70,13,38.5,6,7
407,23,0,117,23,34.8,11,12
407,24,0,97,18,31.9,6,12
407,25,0,99,17,37.0,6,11
407,26,0,75,14,37.6,4,10
407,27,0,59,13,38.3,7,6
407,28,0,69,15,34.9,8,7
407,29,0,92,20,34.7,13,7
407,30,0,81,19,35.2,7,12
408,1,0,101,9,31.4,4,5
408,2,0,70,7,29.3,2,5
408,3,0,93,8,28.1,4,4
408,4,0,92,8,27.3,3,5
408,5,0,60,6,24.0,1,5
408,6,0,61,8,28.9,4,4
408,7,0,61,7,28.2,3,4
408,8,0,79,11,34.3,4,7
408,9,0,74,8,31.0,1,7
408,10,0,68,9,27.6,3,6
408,11,0,77,11,28.6,6,5
408,12,0,63,7,32.2,4,3
408,13,0,52,7,33.1,3,4
408,14,0,44,7,27.7,3,4
408,15,0,70,10,29.7,3,7
408,16,0,99,15,29.5,4,11
408,17,0,87,12,28.4,4,8
408,18,0,79,13,28.8,5,8
408,19,0,90,14,26.9,8,6
408,20,0,53,9,32.9,5,4
408,21,0,60,12,30.5,6,6
408,22,0,69,14,32.0,5,9
408,23,0,96,21,30.1,2,19
408,24,0,67,13,29.9,4,9
408,25,0,80,15,28.9,7,8
408,26,0,73,16,30.7,4,12
408,27,0,57,11,34.4,5,6
408,28,0,59,13,28.4,5,8
408,29,0,44,11,33.4,3,8
408,30,0,59,16,30.5,6,10
409,1,1,153,35,22.7,19,16
409,2,1,88,21,21.0,12,9
409,3,1,111,29,23.0,9,20
409,4,1,87,25,19.3,15,10
409,5,1,119,33,24.6,18,15
409,6,1,83,24,24.3,12,12
409,7,1,65,23,22.0,13,10
409,8,1,66,22,20.8,9,13
409,9,1,125,41,22.9,20,21
409,10,1,100,34,21.5,16,18
409,11,1,127,47,22.8,27,20
409,12,1,130,47,24.9,30,17
409,13,1,82,31,24.9,15,16
409,14,1,69,27,24.5,12,15
409,15,1,131,54,22.5,26,28
409,16,1,129,56,24.0,32,24
409,17,1,111,49,22.0,28,21
409,18,1,109,51,20.7,20,31
409,19,1,116,56,26.6,33,23
409,20,1,88,41,23.4,24,17
409,21,1,77,36,20.2,19,17
409,22,1,117,60,22.0,26,34
409,23,1,104,53,21.6,24,29
409,24,1,109,59,24.3,25,34
409,25,1,103,56,17.5,26,30
409,26,1,128,70,23.2,38,32
409,27,1,71,42,24.0,18,24
409,28,1,68,41,20.7,19,22
409,29,1,118,73,24.6,35,38
409,30,1,159,97,21.4,57,40
410,1,1,40,10,53.4,5,5
410,2,1,55,14,52.2,4,10
410,3,1,55,14,55.6,7,7
410,4,1,47,13,54.9,3,10
410,5,1,50,17,59.0,10,7
410,6,1,21,8,56.6,4,4
410,7,1,26,8,54.6,2,6
410,8,1,57,19,56.1,10,9
410,9,1,35,13,55.8,9,4
410,10,1,37,15,57.5,9,6
410,11,1,36,14,55.3,9,5
410,12,1,66,24,58.3,9,15
410,13,1,28,11,54.5,5,6
410,14,1,37,16,57.8,5,11
410,15,1,37,17,67.6,12,5
410,16,1,71,29,55.0,19,10
410,17,1,33,15,54.1,4,11
410,18,1,51,22,55.6,15,7
410,19,1,27,15,56.2,3,12
410,20,1,34,15,59.0,6,9
410,21,1,49,24,57.5,13,11
410,22,1,5,7,53.1,2,5
410,23,1,26,15,56.6,8,7
410,24,1,51,27,54.3,13,14
410,25,1,71,40,54.0,22,18
410,26,1,62,35,56.9,17,18
410,27,1,28,17,56.2,5,12
410,28,1,38,21,56.8,13,8
410,29,1,34,20,58.2,6,14
410,30,1,18,12,56.0,4,8
411,1,1,86,22,31.8,10,12
411,2,1,103,25,35.3,12,13
411,3,1,69,18,34.2,9,9
411,4,1,55,14,33.2,9,5
411,5,1,71,19,37.4,12,7
411,6,1,42,14,34.3,6,8
411,7,1,35,12,37.9,6,6
411,8,1,37,14,33.6,9,5
411,9,1,48,19,33.1,12,7
411,10,1,61,21,31.3,6,15
411,11,1,85,31,36.6,17,14
411,12,1,48,19,37.2,10,9
411,13,1,46,19,34.7,7,12
411,14,1,58,23,33.9,10,13
411,15,1,68,29,41.7,15,14
411,16,1,85,38,36.1,20,18
411,17,1,52,23,35.7,12,11
411,18,1,72,35,33.6,14,21
411,19,1,72,34,32.6,14,20
411,20,1,34,18,28.4,9,9
411,21,1,44,22,29.8,14,8
411,22,1,59,29,33.1,16,13
411,23,1,59,31,31.8,10,21
411,24,1,86,47,33.3,24,23
411,25,1,71,40,36.0,19,21
411,26,1,42,23,33.2,15,8
411,27,1,42,26,34.2,13,13
411,28,1,38,23,35.8,7,16
411,29,1,51,35,38.4,21,14
411,30,1,79,49,33.9,16,33
412,1,0,4,1,65.9,0,1
412,2,0,31,3,63.9,3,0
412,3,0,18,4,64.0,4,0
412,4,0,18,5,65.3,2,3
412,5,0,21,1,63.6,0,1
412,6,0,0,5,67.3,2,3
412,7,0,12,2,63.9,2,0
412,8,0,13,3,65.8,3,0
412,9,0,15,4,61.6,2,2
412,10,0,0,2,66.0,0,2
412,11,0,0,2,67.3,1,1
412,12,0,0,2,63.5,1,1
412,13,0,8,3,64.7,0,3
412,14,0,14,2,67.0,1,1
412,15,0,34,6,53.9,4,2
412,16,0,6,3,64.9,2,1
412,17,0,24,4,69.0,3,1
412,18,0,2,6,63.4,5,1
412,19,0,4,1,64.3,1,0
412,20,0,22,5,66.6,3,2
412,21,0,9,2,63.5,0,2
412,22,0,25,9,66.0,5,4
412,23,0,39,8,59.3,6,2
412,24,0,33,8,67.3,4,4
412,25,0,26,7,67.8,5,2
412,26,0,14,6,67.3,6,0
412,27,0,15,3,64.2,2,1
412,28,0,2,1,65.6,0,1
412,29,0,22,9,65.4,8,1
412,30,0,8,5,64.3,3,2
413,1,0,86,6,45.6,2,4
413,2,0,69,5,40.0,1,4
413,3,0,44,5,45.0,2,3
413,4,0,46,8,44.8,5,3
413,5,0,45,5,43.1,4,1
413,6,0,15,3,43.5,0,3
413,7,0,27,2,44.0,0,2
413,8,0,63,7,45.4,2,5
413,9,0,36,5,42.7,2,3
413,10,0,65,10,43.6,8,2
413,11,0,82,10,46.2,2,8
413,12,0,71,8,41.1,2,6
413,13,0,43,6,41.7,2,4
413,14,0,29,5,44.9,2,3
413,15,0,37,7,42.3,3,4
413,16,0,37,5,44.6,0,5
413,17,0,52,9,46.4,4,5
413,18,0,44,10,43.0,6,4
413,19,0,52,12,44.1,3,9
413,20,0,47,9,45.8,4,5
413,21,0,39,9,43.4,4,5
413,22,0,59,11,42.4,4,7
413,23,0,67,11,40.2,2,9
413,24,0,55,10,42.7,2,8
413,25,0,64,14,40.5,4,10
413,26,0,64,13,43.8,3,10
413,27,0,33,11,42.9,6,5
413,28,0,21,7,45.1,3,4
413,29,0,56,13,42.8,4,9
413,30,0,68,13,41.9,4,9
414,1,0,1,2,32.6,2,0
414,2,0,25,3,33.3,3,0
414,3,0,0,0,28.2,0,0
414,4,0,17,3,31.0,2,1
414,5,0,8,1,32.9,1,0
414,6,0,0,2,29.4,1,1
414,7,0,6,4,26.2,2,2
414,8,0,8,2,28.5,2,0
414,9,0,20,4,32.7,2,2
414,10,0,6,1,28.6,1,0
414,11,0,11,3,29.9,2,1
414,12,0,18,3,33.2,3,0
414,13,0,3,2,32.3,1,1
414,14,0,0,1,30.0,0,1
414,15,0,0,2,41.4,2,0
414,16,0,14,4,28.1,1,3
414,17,0,1,0,31.3,0,0
414,18,0,9,2,30.5,0,2
414,19,0,28,5,31.5,5,0
414,20,0,5,0,34.4,0,0
414,21,0,5,1,30.5,1,0
414,22,0,18,4,31.1,4,0
414,23,0,9,1,30.7,1,0
414,24,0,0,3,31.3,1,2
414,25,0,19,5,30.0,3,2
414,26,0,9,4,26.3,1,3
414,27,0,23,4,32.8,3,1
414,28,0,21,6,33.1,3,3
414,29,0,8,3,31.3,2,1
414,30,0,14,6,31.0,5,1
415,1,1,100,27,50.0,11,16
415,2,1,106,25,50.1,18,7
415,3,1,111,28,51.2,17,11
415,4,1,129,34,50.2,16,18
415,5,1,109,30,53.2,21,9
415,6,1,77,21,49.2,7,14
415,7,1,84,25,51.9,11,14
415,8,1,104,33,53.9,13,20
415,9,1,112,38,50.3,14,24
415,10,1,140,48,49.4,19,29
415,11,1,112,40,52.8,25,15
415,12,1,105,38,50.3,15,23
415,13,1,69,26,46.0,10,16
415,14,1,73,28,52.2,19,9
415,15,1,112,47,57.6,27,20
415,16,1,134,58,52.5,28,30
415,17,1,135,59,49.5,28,31
415,18,1,137,62,48.8,24,38
415,19,1,106,50,53.3,32,18
415,20,1,70,34,51.0,21,13
415,21,1,70,34,54.0,17,17
415,22,1,116,59,54.5,34,25
415,23,1,88,46,53.0,30,16
415,24,1,102,55,51.0,26,29
415,25,1,105,56,50.2,29,27
415,26,1,99,56,53.9,27,29
415,27,1,81,46,49.9,24,22
415,28,1,87,50,52.8,20,30
415,29,1,75,44,50.5,27,17
415,30,1,136,82,50.0,26,56
416,1,1,50,14,51.7,7,7
416,2,1,18,6,53.3,2,4
416,3,1,47,12,53.8,8,4
416,4,1,36,10,52.2,8,2
416,5,1,41,11,51.4,7,4
416,6,1,17,7,53.8,5,2
416,7,1,21,8,51.1,3,5
416,8,1,33,11,46.9,4,7
416,9,1,29,12,54.6,7,5
416,10,1,39,13,52.1,9,4
416,11,1,33,13,50.2,7,6
416,12,1,40,18,46.8,6,12
416,13,1,39,14,56.7,7,7
416,14,1,19,9,49.9,8,1
416,15,1,57,22,55.5,14,8
416,16,1,35,17,54.8,10,7
416,17,1,15,7,53.5,2,5
416,18,1,21,11,52.7,7,4
416,19,1,14,6,51.8,5,1
416,20,1,17,11,51.5,5,6
416,21,1,26,15,49.2,6,9
416,22,1,56,29,48.8,16,13
416,23,1,12,8,53.0,4,4
416,24,1,50,26,53.0,11,15
416,25,1,15,11,52.1,4,7
416,26,1,25,15,55.0,7,8
416,27,1,0,1,50.4,0,1
416,28,1,11,7,51.9,3,4
416,29,1,43,28,55.0,16,12
416,30,1,33,20,50.7,10,10
417,1,0,28,4,47.7,3,1
417,2,0,14,2,51.2,0,2
417,3,0,31,6,46.3,3,3
417,4,0,46,6,49.6,6,0
417,5,0,37,4,51.2,4,0
417,6,0,12,4,49.1,3,1
417,7,0,0,1,44.9,0,1
417,8,0,36,3,48.5,2,1
417,9,0,38,6,46.9,4,2
417,10,0,41,4,51.1,2,2
417,11,0,35,7,52.2,4,3
417,12,0,49,7,49.2,4,3
417,13,0,11,5,47.6,3,2
417,14,0,4,3,47.5,2,1
417,15,0,38,7,48.7,2,5
417,16,0,33,6,49.4,5,1
417,17,0,31,11,50.3,7,4
417,18,0,7,3,48.4,3,0
417,19,0,28,7,43.0,5,2
417,20,0,18,8,49.5,6,2
417,21,0,33,6,44.8,5,1
417,22,0,47,8,50.3,4,4
417,23,0,19,3,48.8,2,1
417,24,0,37,9,49.9,7,2
417,25,0,6,4,48.2,3,1
417,26,0,36,10,46.4,7,3
417,27,0,0,0,47.1,0,0
417,28,0,25,6,51.0,6,0
417,29,0,35,8,47.9,6,2
417,30,0,42,11,47.9,9,2
418,1,1,55,14,32.5,5,9
418,2,1,53,16,34.0,6,10
418,3,1,27,7,30.1,4,3
418,4,1,1,0,33.0,0,0
418,5,1,24,8,35.5,6,2
418,6,1,22,6,32.8,2,4
418,7,1,38,14,31.4,6,8
418,8,1,39,13,31.6,5,8
418,9,1,0,3,32.4,1,2
418,10,1,30,15,33.8,9,6
418,11,1,21,7,33.2,3,4
418,12,1,44,18,30.9,8,10
418,13,1,36,16,33.1,7,9
418,14,1,30,14,32.9,5,9
418,15,1,57,25,26.7,10,15
418,16,1,37,20,30.9,9,11
418,17,1,19,10,34.1,7,3
418,18,1,21,11,32.2,4,7
418,19,1,26,15,32.5,8,7
418,20,1,29,15,31.3,8,7
418,21,1,23,12,33.6,5,7
418,22,1,29,17,31.5,7,10
418,23,1,39,22,29.0,13,9
418,24,1,43,28,31.4,19,9
418,25,1,58,31,32.7,14,17
418,26,1,43,26,33.5,15,11
418,27,1,32,19,32.5,9,10
418,28,1,29,16,31.2,8,8
418,29,1,10,9,33.8,4,5
418,30,1,41,28,31.0,12,16
419,1,0,78,8,55.7,3,5
419,2,0,71,10,57.1,5,5
419,3,0,96,8,57.5,4,4
419,4,0,86,8,57.2,1,7
419,5,0,65,8,55.4,4,4
419,6,0,43,6,57.2,2,4
419,7,0,42,6,55.0,4,2
419,8,0,78,11,55.5,4,7
419,9,0,47,6,53.7,2,4
419,10,0,61,8,55.7,1,7
419,11,0,74,10,60.9,3,7
419,12,0,63,8,57.4,4,4
419,13,0,33,6,53.5,5,1
419,14,0,35,6,55.3,2,4
419,15,0,80,11,52.7,3,8
419,16,0,7,1,55.7,0,1
419,17,0,91,16,55.1,5,11
419,18,0,85,12,56.2,6,6
419,19,0,70,11,53.9,7,4
419,20,0,44,6,54.9,0,6
419,21,0,57,11,54.3,4,7
419,22,0,63,12,54.5,7,5
419,23,0,46,8,56.7,3,5
419,24,0,58,11,57.8,2,9
419,25,0,64,13,53.7,6,7
419,26,0,28,8,54.9,3,5
419,27,0,48,8,62.0,5,3
419,28,0,29,5,53.7,1,4
419,29,0,65,14,54.7,8,6
419,30,0,80,17,56.4,5,12
420,1,0,50,5,25.4,3,2
420,2,0,28,5,28.1,1,4
420,3,0,35,2,25.3,1,1
420,4,0,14,2,30.2,1,1
420,5,0,24,3,29.5,2,1
420,6,0,9,4,28.1,1,3
420,7,0,4,2,27.9,1,1
420,8,0,28,3,32.0,1,2
420,9,0,22,2,24.8,1,1
420,10,0,3,2,25.0,1,1
420,11,0,31,4,28.9,1,3
420,12,0,23,5,25.9,2,3
420,13,0,15,4,25.6,2,2
420,14,0,24,6,27.1,1,5
420,15,0,24,4,19.8,1,3
420,16,0,57,10,27.9,2,8
420,17,0,38,8,26.3,4,4
420,18,0,34,7,27.7,4,3
420,19,0,53,11,28.6,2,9
420,20,0,6,3,26.2,0,3
420,21,0,15,4,28.8,2,2
420,22,0,17,5,27.8,0,5
420,23,0,24,6,27.5,2,4
420,24,0,41,7,29.2,3,4
420,25,0,27,6,26.7,3,3
420,26,0,44,11,27.8,3,8
420,27,0,1,1,26.9,0,1
420,28,0,18,7,28.3,3,4
420,29,0,18,4,28.0,2,2
420,30,0,22,5,30.9,1,4
421,1,1,95,21,55.4,12,9
421,2,1,86,20,54.9,10,10
421,3,1,89,24,58.0,12,12
421,4,1,97,26,55.5,16,10
421,5,1,75,21,56.0,10,11
421,6,1,47,15,56.8,6,9
421,7,1,42,17,57.0,5,12
421,8,1,71,22,59.7,17,5
421,9,1,82,29,57.6,19,10
421,10,1,99,33,58.2,23,10
421,11,1,95,33,57.6,15,18
421,12,1,100,36,58.3,20,16
421,13,1,41,18,56.3,9,9
421,14,1,61,27,57.1,16,11
421,15,1,66,26,55.9,16,10
421,16,1,94,38,57.2,20,18
421,17,1,40,19,50.9,7,12
421,18,1,80,41,56.7,20,21
421,19,1,86,41,57.7,31,10
421,20,1,67,33,57.1,16,17
421,21,1,55,26,52.7,7,19
421,22,1,77,40,58.7,24,16
421,23,1,62,32,57.0,8,24
421,24,1,103,54,59.7,31,23
421,25,1,75,42,59.0,22,20
421,26,1,79,45,56.0,26,19
421,27,1,54,30,56.0,14,16
421,28,1,69,42,57.7,23,19
421,29,1,50,32,58.3,16,16
421,30,1,92,55,56.0,31,24
422,1,0,11,1,74.7,0,1
422,2,0,36,3,70.3,2,1
422,3,0,32,3,71.9,1,2
422,4,0,30,3,73.3,2,1
422,5,0,9,4,74.5,4,0
422,6,0,23,3,75.0,0,3
422,7,0,27,5,72.3,4,1
422,8,0,24,6,72.2,4,2
422,9,0,17,2,69.8,0,2
422,10,0,31,4,72.3,1,3
422,11,0,35,7,71.1,5,2
422,12,0,26,5,70.8,5,0
422,13,0,14,2,74.1,2,0
422,14,0,7,2,75.2,1,1
422,15,0,40,6,69.9,1,5
422,16,0,36,6,75.6,3,3
422,17,0,11,2,70.5,1,1
422,18,0,0,1,72.5,1,0
422,19,0,38,6,72.1,5,1
422,20,0,27,9,73.3,4,5
422,21,0,3,1,71.5,0,1
422,22,0,30,7,73.3,4,3
422,23,0,33,10,74.7,7,3
422,24,0,19,4,71.2,3,1
422,25,0,45,9,73.0,5,4
422,26,0,34,9,71.7,5,4
422,27,0,14,6,69.2,3,3
422,28,0,19,6,73.2,3,3
422,29,0,24,5,73.1,3,2
422,30,0,34,7,75.3,4,3
423,1,0,60,7,50.6,3,4
423,2,0,55,4,51.3,2,2
423,3,0,68,7,52.6,2,5
423,4,0,43,3,51.6,1,2
423,5,0,84,7,49.6,5,2
423,6,0,22,4,51.6,2,2
423,7,0,23,3,47.2,2,1
423,8,0,13,1,50.8,0,1
423,9,0,57,8,49.9,6,2
423,10,0,44,6,51.0,3,3
423,11,0,29,8,45.9,4,4
423,12,0,41,5,54.2,3,2
423,13,0,12,3,50.4,2,1
423,14,0,39,7,51.0,5,2
423,15,0,23,4,47.9,2,2
423,16,0,39,12,46.2,7,5
423,17,0,26,5,50.9,3,2
423,18,0,64,14,53.2,6,8
423,19,0,54,9,49.3,3,6
423,20,0,30,5,53.7,3,2
423,21,0,12,2,53.7,0,2
423,22,0,21,3,49.0,1,2
423,23,0,40,9,50.5,4,5
423,24,0,60,12,50.0,5,7
423,25,0,52,10,48.3,6,4
423,26,0,35,8,49.5,2,6
423,27,0,14,5,53.0,3,2
423,28,0,47,10,52.4,6,4
423,29,0,44,10,49.6,5,5
423,30,0,62,15,48.3,7,8
424,1,0,70,5,71.9,2,3
424,2,0,79,6,73.3,6,0
424,3,0,81,6,73.3,6,0
424,4,0,85,8,71.8,6,2
424,5,0,80,9,75.1,7,2
424,6,0,85,9,72.2,6,3
424,7,0,59,7,70.9,5,2
424,8,0,114,14,73.6,7,7
424,9,0,121,13,74.2,10,3
424,10,0,86,14,72.3,11,3
424,11,0,90,11,75.9,8,3
424,12,0,88,12,73.9,6,6
424,13,0,49,6,73.1,6,0
424,14,0,58,8,76.7,5,3
424,15,0,108,15,68.0,8,7
424,16,0,83,16,73.1,9,7
424,17,0,79,15,73.5,12,3
424,18,0,90,17,78.6,11,6
424,19,0,103,17,75.3,14,3
424,20,0,62,9,73.9,9,0
424,21,0,64,10,76.3,6,4
424,22,0,72,13,72.6,7,6
424,23,0,123,22,74.3,15,7
424,24,0,76,18,73.6,10,8
424,25,0,70,15,70.5,9,6
424,26,0,81,18,71.2,12,6
424,27,0,62,12,74.5,8,4
424,28,0,64,13,75.4,9,4
424,29,0,99,21,75.4,14,7
424,30,0,99,23,73.5,12,11
425,1,1,44,12,56.1,10,2
425,2,1,82,20,53.9,10,10
425,3,1,71,18,51.0,9,9
425,4,1,58,16,52.1,10,6
425,5,1,47,13,55.8,8,5
425,6,1,49,16,50.9,12,4
425,7,1,42,14,53.3,7,7
425,8,1,66,23,55.3,16,7
425,9,1,68,22,52.0,8,14
425,10,1,44,15,51.5,7,8
425,11,1,59,22,54.9,13,9
425,12,1,73,29,57.1,10,19
425,13,1,48,17,50.3,9,8
425,14,1,49,20,53.7,8,12
425,15,1,62,26,52.3,14,12
425,16,1,54,23,55.0,12,11
425,17,1,58,26,56.7,10,16
425,18,1,77,35,50.6,20,15
425,19,1,56,30,53.5,18,12
425,20,1,30,15,53.5,6,9
425,21,1,50,26,53.2,9,17
425,22,1,76,38,55.5,20,18
425,23,1,46,26,50.6,13,13
425,24,1,47,26,51.2,15,11
425,25,1,56,30,53.5,21,9
425,26,1,46,30,53.6,15,15
425,27,1,29,16,55.1,10,6
425,28,1,25,15,52.1,6,9
425,29,1,65,42,54.4,27,15
425,30,1,32,22,53.2,10,12
426,1,0,25,3,35.0,2,1
426,2,0,34,4,36.0,4,0
426,3,0,10,0,44.2,0,0
426,4,0,19,5,39.6,3,2
426,5,0,37,3,38.6,0,3
426,6,0,22,5,36.2,1,4
426,7,0,16,5,40.8,1,4
426,8,0,19,1,38.8,1,0
426,9,0,3,1,35.8,0,1
426,10,0,12,2,39.9,1,1
426,11,0,62,7,39.0,4,3
426,12,0,14,5,38.4,3,2
426,13,0,14,1,39.5,1,0
426,14,0,21,3,37.0,2,1
426,15,0,1,0,29.2,0,0
426,16,0,10,4,41.0,1,3
426,17,0,8,3,36.2,2,1
426,18,0,1,1,41.3,0,1
426,19,0,0,2,43.1,1,1
426,20,0,28,4,42.7,2,2
426,21,0,27,7,37.9,3,4
426,22,0,27,7,41.7,3,4
426,23,0,27,6,39.1,2,4
426,24,0,18,6,38.0,4,2
426,25,0,45,9,41.0,3,6
426,26,0,33,7,36.0,4,3
426,27,0,10,1,35.3,0,1
426,28,0,18,5,36.8,2,3
426,29,0,32,10,38.4,4,6
426,30,0,6,4,39.2,2,2
427,1,0,106,7,44.1,5,2
427,2,0,68,5,41.7,3,2
427,3,0,80,7,47.5,3,4
427,4,0,118,12,46.1,8,4
427,5,0,121,10,47.6,6,4
427,6,0,84,12,43.6,8,4
427,7,0,68,8,46.7,5,3
427,8,0,94,11,46.1,6,5
427,9,0,106,12,47.5,7,5
427,10,0,82,9,46.4,6,3
427,11,0,79,10,41.7,4,6
427,12,0,77,14,42.1,9,5
427,13,0,65,8,44.4,3,5
427,14,0,67,12,47.9,11,1
427,15,0,80,12,55.6,9,3
427,16,0,108,14,44.4,7,7
427,17,0,106,16,44.1,12,4
427,18,0,84,13,45.3,8,5
427,19,0,79,15,45.7,13,2
427,20,0,73,12,44.4,11,1
427,21,0,65,11,44.2,6,5
427,22,0,117,21,43.8,14,7
427,23,0,91,18,44.6,13,5
427,24,0,91,17,44.8,11,6
427,25,0,109,20,48.5,16,4
427,26,0,100,22,47.7,17,5
427,27,0,68,13,46.2,7,6
427,28,0,77,16,48.3,12,4
427,29,0,108,23,45.6,10,13
427,30,0,111,23,44.6,14,9
428,1,0,66,7,26.9,2,5
428,2,0,98,8,28.8,2,6
428,3,0,98,10,28.4,3,7
428,4,0,51,7,27.9,2,5
428,5,0,57,6,28.1,1,5
428,6,0,59,6,31.4,5,1
428,7,0,66,8,28.8,5,3
428,8,0,104,11,32.2,3,8
428,9,0,70,8,28.5,3,5
428,10,0,67,8,29.2,4,4
428,11,0,60,7,25.3,2,5
428,12,0,82,10,30.8,1,9
428,13,0,48,7,31.9,1,6
428,14,0,46,8,28.9,4,4
428,15,0,108,17,39.5,4,13
428,16,0,91,12,28.5,4,8
428,17,0,58,9,32.6,6,3
428,18,0,75,12,29.1,4,8
428,19,0,87,14,29.6,5,9
428,20,0,72,12,30.2,1,11
428,21,0,48,8,31.1,1,7
428,22,0,85,16,29.2,5,11
428,23,0,91,17,25.3,4,13
428,24,0,90,17,25.4,5,12
428,25,0,95,18,28.9,6,12
428,26,0,88,17,28.9,6,11
428,27,0,81,16,32.8,4,12
428,28,0,56,11,31.0,2,9
428,29,0,86,16,31.1,6,10
428,30,0,67,16,29.6,6,10
429,1,0,65,10,45.9,3,7
429,2,0,111,9,43.8,4,5
429,3,0,87,8,48.1,6,2
429,4,0,87,12,44.9,4,8
429,5,0,76,7,45.0,2,5
429,6,0,71,7,46.5,3,4
429,7,0,58,6,44.9,4,2
429,8,0,74,9,44.6,5,4
429,9,0,107,14,43.7,6,8
429,10,0,93,11,46.5,6,5
429,11,0,110,12,40.0,5,7
429,12,0,94,11,43.3,4,7
429,13,0,65,11,44.8,5,6
429,14,0,54,8,46.1,6,2
429,15,0,104,16,50.6,10,6
429,16,0,114,15,40.9,9,6
429,17,0,109,18,42.5,10,8
429,18,0,65,9,42.2,5,4
429,19,0,88,14,41.0,6,8
429,20,0,52,10,46.1,5,5
429,21,0,59,11,44.4,5,6
429,22,0,97,16,44.5,7,9
429,23,0,91,17,45.6,10,7
429,24,0,107,22,42.0,12,10
429,25,0,113,23,42.2,12,11
429,26,0,109,21,45.2,13,8
429,27,0,62,15,42.3,5,10
429,28,0,85,18,44.7,7,11
429,29,0,90,21,42.6,14,7
429,30,0,102,20,44.2,12,8
430,1,0,56,6,61.7,2,4
430,2,0,51,5,59.1,3,2
430,3,0,44,3,58.0,3,0
430,4,0,76,9,54.2,7,2
430,5,0,46,6,58.4,4,2
430,6,0,35,6,61.6,4,2
430,7,0,42,7,57.4,5,2
430,8,0,90,11,57.9,8,3
430,9,0,61,9,56.6,6,3
430,10,0,66,13,55.7,6,7
430,11,0,42,8,55.4,5,3
430,12,0,59,10,57.1,7,3
430,13,0,44,6,57.7,3,3
430,14,0,53,7,57.8,4,3
430,15,0,71,14,54.7,9,5
430,16,0,64,9,59.0,5,4
430,17,0,79,15,60.2,10,5
430,18,0,76,12,55.0,8,4
430,19,0,58,13,58.9,10,3
430,20,0,33,5,57.9,4,1
430,21,0,59,13,63.3,5,8
430,22,0,92,16,58.6,13,3
430,23,0,47,8,55.1,4,4
430,24,0,65,12,57.2,9,3
430,25,0,65,17,55.7,10,7
430,26,0,46,8,61.8,7,1
430,27,0,62,13,55.8,7,6
430,28,0,46,11,61.6,6,5
430,29,0,59,12,60.0,7,5
430,30,0,71,16,54.4,12,4
431,1,0,76,6,80.5,1,5
431,2,0,59,9,76.8,3,6
431,3,0,98,9,73.7,3,6
431,4,0,113,9,76.6,3,6
431,5,0,73,8,73.7,0,8
431,6,0,55,8,75.0,1,7
431,7,0,38,8,76.9,2,6
431,8,0,103,12,77.4,6,6
431,9,0,70,7,73.5,2,5
431,10,0,69,13,76.0,7,6
431,11,0,74,10,76.0,3,7
431,12,0,61,7,77.6,2,5
431,13,0,52,9,78.1,3,6
431,14,0,55,8,74.1,0,8
431,15,0,86,15,75.9,4,11
431,16,0,78,11,78.1,6,5
431,17,0,87,13,75.6,5,8
431,18,0,124,21,73.1,5,16
431,19,0,81,15,77.1,4,11
431,20,0,46,7,76.2,1,6
431,21,0,46,10,74.9,0,10
431,22,0,74,13,76.9,4,9
431,23,0,56,14,74.4,3,11
431,24,0,55,11,76.7,3,8
431,25,0,81,18,72.9,5,13
431,26,0,76,15,73.4,10,5
431,27,0,68,14,76.0,6,8
431,28,0,53,10,73.6,6,4
431,29,0,62,12,73.1,2,10
431,30,0,72,19,74.1,11,8
432,1,0,73,8,70.7,2,6
432,2,0,89,8,70.5,3,5
432,3,0,77,6,67.7,5,1
432,4,0,49,5,70.6,3,2
432,5,0,92,10,68.5,5,5
432,6,0,53,7,68.3,4,3
432,7,0,35,5,68.9,2,3
432,8,0,46,7,68.7,3,4
432,9,0,69,8,72.2,5,3
432,10,0,75,13,68.1,3,10
432,11,0,86,13,74.2,6,7
432,12,0,61,10,71.6,5,5
432,13,0,46,6,68.0,2,4
432,14,0,59,9,69.5,4,5
432,15,0,69,10,67.0,4,6
432,16,0,69,13,73.0,7,6
432,17,0,87,14,67.9,10,4
432,18,0,72,10,73.1,6,4
432,19,0,66,10,70.3,6,4
432,20,0,46,9,68.5,5,4
432,21,0,30,6,69.0,1,5
432,22,0,80,14,70.3,9,5
432,23,0,95,16,70.1,10,6
432,24,0,72,14,69.3,6,8
432,25,0,77,14,70.2,6,8
432,26,0,78,16,72.7,6,10
432,27,0,42,7,67.6,1,6
432,28,0,35,8,68.9,2,6
432,29,0,58,12,69.9,6,6
432,30,0,82,19,67.6,11,8
433,1,1,74,18,68.5,8,10
433,2,1,55,13,67.3,12,1
433,3,1,70,18,67.7,6,12
433,4,1,34,9,62.9,5,4
433,5,1,42,11,66.7,6,5
433,6,1,55,15,66.4,7,8
433,7,1,32,11,65.6,6,5
433,8,1,43,13,67.6,10,3
433,9,1,67,24,66.2,10,14
433,10,1,70,26,68.1,10,16
433,11,1,82,30,67.0,11,19
433,12,1,62,27,65.2,12,15
433,13,1,40,14,68.0,6,8
433,14,1,48,19,64.7,8,11
433,15,1,82,33,72.1,12,21
433,16,1,57,24,70.5,17,7
433,17,1,51,21,67.6,13,8
433,18,1,41,22,65.1,11,11
433,19,1,95,45,63.6,20,25
433,20,1,43,22,65.9,9,13
433,21,1,34,20,66.8,9,11
433,22,1,41,22,68.0,9,13
433,23,1,86,45,68.2,19,26
433,24,1,80,44,65.4,29,15
433,25,1,80,45,71.5,19,26
433,26,1,85,49,67.8,27,22
433,27,1,40,24,68.7,9,15
433,28,1,24,13,64.8,8,5
433,29,1,72,45,69.3,25,20
433,30,1,50,30,65.8,13,17
434,1,1,10,5,57.3,3,2
434,2,1,24,7,58.4,5,2
434,3,1,31,8,58.6,7,1
434,4,1,4,1,59.8,1,0
434,5,1,44,14,58.5,10,4
434,6,1,15,4,53.8,1,3
434,7,1,15,4,55.9,3,1
434,8,1,20,6,54.1,4,2
434,9,1,36,14,60.4,8,6
434,10,1,27,12,54.4,4,8
434,11,1,17,8,56.1,4,4
434,12,1,32,12,57.7,6,6
434,13,1,9,4,58.7,2,2
434,14,1,8,4,57.2,3,1
434,15,1,35,14,65.9,7,7
434,16,1,39,16,59.6,13,3
434,17,1,26,11,60.9,6,5
434,18,1,24,12,55.5,5,7
434,19,1,12,8,56.6,4,4
434,20,1,27,15,59.7,8,7
434,21,1,24,11,58.7,7,4
434,22,1,0,4,58.0,0,4
434,23,1,13,9,58.3,6,3
434,24,1,16,11,56.9,4,7
434,25,1,41,22,58.6,12,10
434,26,1,0,3,61.4,1,2
434,27,1,10,6,58.6,4,2
434,28,1,0,1,56.8,0,1
434,29,1,16,11,56.1,4,7
434,30,1,20,13,57.1,6,7
435,1,0,0,4,34.1,2,2
435,2,0,35,5,30.5,2,3
435,3,0,41,3,33.7,2,1
435,4,0,26,6,31.8,3,3
435,5,0,9,4,34.7,3,1
435,6,0,9,3,33.0,2,1
435,7,0,11,3,36.7,1,2
435,8,0,12,2,31.3,1,1
435,9,0,16,2,33.8,2,0
435,10,0,1,5,31.2,4,1
435,11,0,42,4,33.1,3,1
435,12,0,0,2,30.1,2,0
435,13,0,14,6,36.0,5,1
435,14,0,22,5,34.0,3,2
435,15,0,13,3,26.4,3,0
435,16,0,0,0,34.6,0,0
435,17,0,18,5,32.4,4,1
435,18,0,1,2,36.0,2,0
435,19,0,36,8,35.6,5,3
435,20,0,37,5,34.8,3,2
435,21,0,7,2,33.4,1,1
435,22,0,0,1,33.6,1,0
435,23,0,14,5,33.5,4,1
435,24,0,0,1,30.7,0,1
435,25,0,0,1,31.5,1,0
435,26,0,31,6,34.0,4,2
435,27,0,19,4,33.0,2,2
435,28,0,2,1,33.5,1,0
435,29,0,0,1,32.5,1,0
435,30,0,37,9,32.7,6,3
436,1,0,111,8,32.4,4,4
436,2,0,97,10,30.7,7,3
436,3,0,86,8,33.3,7,1
436,4,0,104,9,31.1,8,1
436,5,0,107,9,34.3,8,1
436,6,0,74,8,35.7,5,3
436,7,0,84,8,33.3,6,2
436,8,0,92,13,31.6,5,8
436,9,0,81,9,31.8,5,4
436,10,0,100,17,28.8,8,9
436,11,0,110,14,30.4,4,10
436,12,0,133,20,35.4,13,7
436,13,0,67,8,35.9,4,4
436,14,0,58,10,35.4,7,3
436,15,0,107,15,35.8,7,8
436,16,0,91,13,35.1,9,4
436,17,0,100,14,33.2,11,3
436,18,0,92,16,33.5,12,4
436,19,0,87,14,35.3,10,4
436,20,0,58,12,35.1,7,5
436,21,0,88,16,33.0,10,6
436,22,0,91,18,30.7,11,7
436,23,0,99,17,34.8,12,5
436,24,0,80,13,33.5,8,5
436,25,0,53,12,31.6,7,5
436,26,0,99,19,31.6,13,6
436,27,0,65,12,31.3,6,6
436,28,0,70,15,34.3,7,8
436,29,0,98,20,29.2,11,9
436,30,0,82,20,33.9,9,11
437,1,1,115,28,42.9,13,15
437,2,1,115,28,44.1,14,14
437,3,1,112,29,45.5,7,22
437,4,1,97,25,42.8,11,14
437,5,1,100,29,41.4,17,12
437,6,1,82,25,46.8,15,10
437,7,1,76,25,44.3,13,12
437,8,1,115,36,41.9,17,19
437,9,1,93,33,47.0,11,22
437,10,1,97,36,46.2,18,18
437,11,1,106,38,45.4,17,21
437,12,1,107,39,44.9,18,21
437,13,1,99,38,46.6,19,19
437,14,1,91,38,43.1,23,15
437,15,1,136,56,45.6,34,22
437,16,1,86,41,42.0,23,18
437,17,1,111,49,44.8,21,28
437,18,1,115,51,43.6,24,27
437,19,1,102,47,43.2,23,24
437,20,1,78,40,46.2,16,24
437,21,1,74,37,43.8,19,18
437,22,1,132,65,43.7,26,39
437,23,1,93,49,47.8,21,28
437,24,1,76,42,42.5,23,19
437,25,1,97,53,46.6,22,31
437,26,1,93,51,43.6,28,23
437,27,1,65,40,45.6,20,20
437,28,1,90,51,45.6,18,33
437,29,1,126,76,46.4,42,34
437,30,1,79,50,42.2,31,19
438,1,0,84,7,58.6,3,4
438,2,0,73,8,59.8,5,3
438,3,0,81,7,59.5,4,3
438,4,0,99,8,56.7,5,3
438,5,0,96,12,59.3,4,8
438,6,0,59,7,60.1,3,4
438,7,0,59,8,57.7,5,3
438,8,0,94,10,60.1,5,5
438,9,0,56,7,58.9,4,3
438,10,0,103,12,58.8,6,6
438,11,0,76,9,58.5,6,3
438,12,0,69,10,58.7,6,4
438,13,0,67,14,53.5,8,6
438,14,0,61,8,58.8,5,3
438,15,0,93,13,64.1,6,7
438,16,0,76,10,58.2,6,4
438,17,0,45,8,61.3,1,7
438,18,0,125,21,55.7,12,9
438,19,0,66,10,62.2,6,4
438,20,0,70,12,63.2,6,6
438,21,0,52,13,56.7,8,5
438,22,0,66,12,60.2,5,7
438,23,0,75,13,57.9,7,6
438,24,0,89,15,59.9,12,3
438,25,0,67,12,57.5,6,6
438,26,0,91,20,63.2,12,8
438,27,0,60,13,56.5,4,9
438,28,0,53,13,62.3,5,8
438,29,0,55,13,60.3,6,7
438,30,0,101,24,57.8,16,8
439,1,1,82,19,68.0,9,10
439,2,1,128,30,72.6,14,16
439,3,1,133,35,70.4,17,18
439,4,1,123,32,71.1,10,22
439,5,1,132,36,69.6,21,15
439,6,1,79,26,68.9,14,12
439,7,1,67,21,73.6,11,10
439,8,1,111,38,69.9,18,20
439,9,1,101,33,66.9,18,15
439,10,1,95,35,71.8,17,18
439,11,1,97,35,71.7,10,25
439,12,1,117,44,68.6,28,16
439,13,1,80,29,69.9,17,12
439,14,1,92,36,73.4,21,15
439,15,1,114,46,71.4,22,24
439,16,1,126,56,74.3,34,22
439,17,1,119,51,70.8,22,29
439,18,1,111,51,72.3,25,26
439,19,1,100,46,70.9,28,18
439,20,1,75,36,69.3,20,16
439,21,1,74,37,71.0,18,19
439,22,1,120,62,65.7,27,35
439,23,1,107,55,70.2,34,21
439,24,1,91,51,69.6,19,32
439,25,1,113,61,69.4,28,33
439,26,1,104,57,74.2,29,28
439,27,1,87,52,64.7,24,28
439,28,1,66,38,73.1,19,19
439,29,1,122,75,69.6,39,36
439,30,1,136,85,70.0,39,46
440,1,0,87,6,33.2,5,1
440,2,0,88,7,35.4,1,6
440,3,0,79,9,33.3,5,4
440,4,0,67,6,37.0,3,3
440,5,0,81,8,36.2,4,4
440,6,0,78,7,33.8,4,3
440,7,0,70,11,35.1,5,6
440,8,0,101,12,36.8,5,7
440,9,0,103,13,33.9,6,7
440,10,0,64,10,30.3,4,6
440,11,0,103,13,34.8,6,7
440,12,0,93,13,35.1,8,5
440,13,0,65,8,31.7,6,2
440,14,0,73,11,35.2,6,5
440,15,0,94,14,41.6,7,7
440,16,0,104,15,35.9,6,9
440,17,0,86,13,35.9,9,4
440,18,0,90,14,37.2,7,7
440,19,0,83,13,35.1,9,4
440,20,0,57,11,32.6,6,5
440,21,0,78,13,34.5,7,6
440,22,0,102,17,33.4,10,7
440,23,0,98,19,36.3,12,7
440,24,0,90,17,37.0,12,5
440,25,0,84,16,35.5,10,6
440,26,0,68,14,32.5,7,7
440,27,0,77,16,36.2,7,9
440,28,0,56,13,36.3,7,6
440,29,0,68,15,32.5,7,8
440,30,0,118,27,34.0,12,15
441,1,0,47,6,61.1,2,4
441,2,0,68,5,59.1,1,4
441,3,0,76,8,64.1,2,6
441,4,0,60,6,60.6,0,6
441,5,0,77,8,61.3,2,6
441,6,0,26,6,61.0,0,6
441,7,0,40,4,60.7,2,2
441,8,0,62,11,62.9,6,5
441,9,0,60,8,62.5,2,6
441,10,0,63,8,60.7,3,5
441,11,0,71,9,61.0,1,8
441,12,0,56,8,57.6,6,2
441,13,0,36,6,60.8,3,3
441,14,0,24,5,57.4,2,3
441,15,0,63,12,56.5,5,7
441,16,0,59,12,61.3,3,9
441,17,0,61,12,59.3,1,11
441,18,0,72,12,60.7,4,8
441,19,0,71,15,58.1,5,10
441,20,0,19,5,59.9,3,2
441,21,0,36,7,60.8,1,6
441,22,0,39,7,62.4,5,2
441,23,0,57,10,64.5,5,5
441,24,0,50,8,63.5,3,5
441,25,0,33,10,59.5,3,7
441,26,0,60,13,59.5,2,11
441,27,0,45,8,57.5,2,6
441,28,0,63,13,60.4,4,9
441,29,0,56,11,62.4,3,8
441,30,0,47,13,59.0,3,10
442,1,1,89,22,50.8,8,14
442,2,1,53,13,45.6,4,9
442,3,1,102,27,49.8,9,18
442,4,1,93,25,50.8,16,9
442,5,1,86,22,48.8,10,12
442,6,1,64,20,48.3,9,11
442,7,1,53,16,50.9,7,9
442,8,1,96,34,45.6,18,16
442,9,1,69,26,49.0,17,9
442,10,1,65,21,44.6,9,12
442,11,1,68,23,49.0,8,15
442,12,1,80,30,48.3,20,10
442,13,1,64,25,45.6,11,14
442,14,1,75,29,47.4,12,17
442,15,1,91,38,51.9,21,17
442,16,1,84,35,47.8,20,15
442,17,1,59,29,51.0,16,13
442,18,1,83,36,48.8,19,17
442,19,1,82,40,49.9,29,11
442,20,1,55,27,45.6,11,16
442,21,1,63,33,47.2,9,24
442,22,1,101,51,47.6,29,22
442,23,1,90,46,49.3,22,24
442,24,1,81,42,47.5,22,20
442,25,1,76,41,48.4,19,22
442,26,1,79,45,46.4,23,22
442,27,1,69,39,51.3,18,21
442,28,1,50,30,47.9,18,12
442,29,1,93,57,48.1,31,26
442,30,1,91,55,48.5,25,30
443,1,0,39,4,31.1,2,2
443,2,0,22,2,30.4,2,0
443,3,0,0,4,34.1,3,1
443,4,0,25,4,29.0,4,0
443,5,0,30,3,31.0,3,0
443,6,0,15,1,30.3,0,1
443,7,0,25,2,28.4,2,0
443,8,0,34,3,28.9,2,1
443,9,0,2,4,26.1,2,2
443,10,0,13,3,28.1,2,1
443,11,0,0,3,28.0,1,2
443,12,0,0,1,31.4,1,0
443,13,0,12,2,26.7,2,0
443,14,0,5,1,30.0,1,0
443,15,0,2,2,31.4,2,0
443,16,0,42,7,28.8,5,2
443,17,0,41,6,28.3,6,0
443,18,0,23,5,34.8,2,3
443,19,0,26,7,33.0,5,2
443,20,0,5,1,27.4,0,1
443,21,0,6,0,30.6,0,0
443,22,0,24,4,27.8,3,1
443,23,0,41,7,25.2,5,2
443,24,0,13,3,25.8,2,1
443,25,0,12,2,27.0,0,2
443,26,0,6,4,29.6,3,1
443,27,0,29,6,32.0,6,0
443,28,0,14,3,27.4,3,0
443,29,0,19,3,30.8,3,0
443,30,0,28,5,28.7,0,5
444,1,0,63,5,68.4,3,2
444,2,0,70,7,66.4,2,5
444,3,0,56,5,67.9,3,2
444,4,0,73,8,68.4,6,2
444,5,0,69,7,66.2,1,6
444,6,0,47,7,68.0,2,5
444,7,0,36,6,67.6,3,3
444,8,0,71,8,70.0,2,6
444,9,0,80,11,67.1,1,10
444,10,0,72,10,67.8,4,6
444,11,0,42,5,69.6,3,2
444,12,0,60,8,65.7,3,5
444,13,0,48,7,68.8,3,4
444,14,0,48,10,70.4,5,5
444,15,0,42,9,74.0,4,5
444,16,0,89,13,67.9,3,10
444,17,0,57,8,68.7,2,6
444,18,0,89,15,69.4,5,10
444,19,0,58,10,69.2,5,5
444,20,0,28,6,68.2,1,5
444,21,0,42,9,70.5,2,7
444,22,0,70,14,70.6,5,9
444,23,0,40,9,68.5,4,5
444,24,0,86,15,66.4,3,12
444,25,0,81,15,66.6,5,10
444,26,0,65,12,66.4,5,7
444,27,0,46,9,68.8,1,8
444,28,0,40,8,64.9,1,7
444,29,0,47,9,67.5,4,5
444,30,0,38,7,70.0,2,5
445,1,0,30,4,36.3,2,2
445,2,0,29,6,35.3,3,3
445,3,0,13,5,39.8,2,3
445,4,0,1,2,37.2,2,0
445,5,0,12,5,36.1,2,3
445,6,0,17,1,42.1,1,0
445,7,0,23,4,36.5,3,1
445,8,0,0,2,39.8,2,0
445,9,0,0,1,37.1,1,0
445,10,0,8,3,39.8,1,2
445,11,0,11,3,38.5,3,0
445,12,0,17,5,40.0,3,2
445,13,0,0,1,41.0,0,1
445,14,0,24,7,36.3,6,1
445,15,0,22,5,41.1,3,2
445,16,0,10,6,38.5,2,4
445,17,0,56,8,35.1,5,3
445,18,0,10,5,37.7,3,2
445,19,0,6,2,37.7,1,1
445,20,0,1,0,38.0,0,0
445,21,0,17,6,37.8,4,2
445,22,0,14,5,38.9,3,2
445,23,0,42,11,34.4,6,5
445,24,0,14,7,36.2,4,3
445,25,0,5,1,37.8,1,0
445,26,0,4,2,37.8,0,2
445,27,0,19,3,38.5,2,1
445,28,0,0,3,36.0,1,2
445,29,0,21,6,36.4,1,5
445,30,0,32,6,35.3,3,3
446,1,0,32,3,76.5,2,1
446,2,0,69,7,75.3,4,3
446,3,0,63,7,71.7,4,3
446,4,0,56,4,76.7,1,3
446,5,0,57,6,73.5,4,2
446,6,0,25,5,73.4,2,3
446,7,0,24,2,72.1,0,2
446,8,0,53,5,72.6,2,3
446,9,0,48,7,73.8,3,4
446,10,0,45,7,75.3,3,4
446,11,0,40,5,72.5,3,2
446,12,0,47,7,74.8,5,2
446,13,0,16,4,75.3,1,3
446,14,0,18,4,75.6,3,1
446,15,0,27,5,78.3,5,0
446,16,0,47,8,76.0,4,4
446,17,0,49,6,73.1,2,4
446,18,0,45,9,74.4,6,3
446,19,0,25,7,72.6,4,3
446,20,0,19,3,74.2,2,1
446,21,0,45,7,73.7,0,7
446,22,0,44,8,75.1,4,4
446,23,0,73,14,72.5,5,9
446,24,0,52,12,73.3,7,5
446,25,0,48,10,75.2,6,4
446,26,0,48,9,70.5,4,5
446,27,0,31,8,73.9,3,5
446,28,0,36,8,75.2,3,5
446,29,0,68,18,73.7,9,9
446,30,0,64,13,72.5,8,5
447,1,0,87,10,50.9,5,5
447,2,0,96,12,55.8,6,6
447,3,0,94,7,55.5,4,3
447,4,0,115,10,51.5,4,6
447,5,0,75,7,51.8,3,4
447,6,0,67,7,52.4,4,3
447,7,0,56,6,52.7,4,2
447,8,0,110,12,50.6,3,9
447,9,0,110,12,54.6,6,6
447,10,0,72,10,51.4,4,6
447,11,0,62,9,54.6,3,6
447,12,0,101,14,51.3,5,9
447,13,0,75,11,47.5,7,4
447,14,0,64,9,55.9,3,6
447,15,0,105,19,48.2,9,10
447,16,0,90,17,51.5,4,13
447,17,0,111,18,52.0,3,15
447,18,0,102,16,51.3,6,10
447,19,0,104,17,50.2,8,9
447,20,0,82,14,52.4,1,13
447,21,0,66,12,53.5,1,11
447,22,0,91,15,47.9,5,10
447,23,0,100,18,50.4,6,12
447,24,0,102,21,49.2,6,15
447,25,0,75,14,51.2,9,5
447,26,0,63,12,49.8,3,9
447,27,0,63,13,55.2,6,7
447,28,0,63,14,51.8,5,9
447,29,0,97,22,49.9,7,15
447,30,0,104,23,52.3,12,11
448,1,0,82,6,38.2,2,4
448,2,0,99,9,38.5,4,5
448,3,0,122,9,36.0,3,6
448,4,0,116,10,39.7,3,7
448,5,0,122,13,36.2,5,8
448,6,0,65,8,42.6,5,3
448,7,0,59,7,44.6,3,4
448,8,0,123,14,38.6,7,7
448,9,0,92,10,39.4,4,6
448,10,0,134,18,39.5,5,13
448,11,0,117,15,39.6,6,9
448,12,0,93,15,43.1,8,7
448,13,0,87,15,38.4,7,8
448,14,0,99,14,39.2,8,6
448,15,0,119,18,45.6,6,12
448,16,0,120,18,38.9,3,15
448,17,0,90,12,39.8,4,8
448,18,0,111,20,44.3,8,12
448,19,0,94,16,43.4,4,12
448,20,0,74,12,37.3,3,9
448,21,0,80,15,39.1,6,9
448,22,0,113,18,38.9,4,14
448,23,0,107,20,39.5,6,14
448,24,0,120,23,40.8,10,13
448,25,0,91,18,42.8,5,13
448,26,0,125,25,39.8,9,16
448,27,0,75,17,37.1,2,15
448,28,0,81,16,36.3,4,12
448,29,0,93,19,40.6,6,13
448,30,0,101,22,40.0,8,14
449,1,0,116,8,19.3,5,3
449,2,0,78,7,26.6,4,3
449,3,0,48,7,25.4,4,3
449,4,0,80,6,21.0,2,4
449,5,0,78,8,25.0,2,6
449,6,0,42,6,22.6,3,3
449,7,0,57,7,25.1,2,5
449,8,0,72,9,26.5,4,5
449,9,0,73,13,24.8,4,9
449,10,0,67,8,23.5,4,4
449,11,0,81,12,25.7,7,5
449,12,0,45,5,21.5,3,2
449,13,0,49,6,24.1,2,4
449,14,0,57,7,26.1,3,4
449,15,0,82,13,22.9,7,6
449,16,0,85,11,21.6,5,6
449,17,0,73,11,20.9,4,7
449,18,0,51,8,25.2,4,4
449,19,0,68,15,26.7,7,8
449,20,0,53,11,24.8,4,7
449,21,0,54,12,23.7,5,7
449,22,0,73,15,21.1,3,12
449,23,0,99,20,25.1,12,8
449,24,0,93,19,25.4,8,11
449,25,0,85,16,25.1,6,10
449,26,0,88,21,25.9,13,8
449,27,0,52,9,25.2,5,4
449,28,0,55,12,28.0,5,7
449,29,0,100,19,24.9,13,6
449,30,0,95,20,25.7,12,8
450,1,0,18,1,39.7,0,1
450,2,0,41,4,34.8,1,3
450,3,0,24,1,38.4,0,1
450,4,0,44,6,37.4,4,2
450,5,0,17,4,33.9,2,2
450,6,0,21,2,34.5,1,1
450,7,0,28,5,37.4,5,0
450,8,0,31,7,31.2,4,3
450,9,0,15,2,31.8,1,1
450,10,0,11,4,34.9,3,1
450,11,0,37,4,37.4,2,2
450,12,0,39,5,34.0,3,2
450,13,0,19,3,36.3,3,0
450,14,0,24,5,32.3,3,2
450,15,0,33,5,34.8,5,0
450,16,0,32,5,35.6,2,3
450,17,0,34,7,37.1,4,3
450,18,0,39,6,36.1,3,3
450,19,0,28,6,37.0,1,5
450,20,0,2,2,34.8,2,0
450,21,0,24,6,32.6,3,3
450,22,0,32,6,35.9,1,5
450,23,0,30,8,35.3,4,4
450,24,0,28,7,35.2,5,2
450,25,0,19,5,38.2,1,4
450,26,0,41,8,37.3,7,1
450,27,0,16,6,33.3,3,3
450,28,0,0,1,35.8,1,0
450,29,0,28,6,35.6,1,5
450,30,0,21,6,34.1,4,2
451,1,0,29,4,56.4,2,2
451,2,0,23,3,55.9,2,1
451,3,0,40,5,55.9,2,3
451,4,0,0,0,51.7,0,0
451,5,0,17,3,58.5,2,1
451,6,0,0,0,54.5,0,0
451,7,0,0,2,55.1,2,0
451,8,0,11,1,54.1,1,0
451,9,0,24,4,54.7,4,0
451,10,0,10,4,54.8,2,2
451,11,0,10,2,53.9,1,1
451,12,0,11,4,53.1,3,1
451,13,0,0,4,55.9,3,1
451,14,0,0,3,56.4,2,1
451,15,0,17,3,54.3,3,0
451,16,0,20,3,57.4,3,0
451,17,0,16,3,54.3,2,1
451,18,0,4,1,57.0,1,0
451,19,0,14,8,56.0,5,3
451,20,0,12,3,59.8,2,1
451,21,0,0,4,54.2,2,2
451,22,0,4,0,50.1,0,0
451,23,0,11,4,55.1,3,1
451,24,0,20,5,58.6,3,2
451,25,0,52,13,54.6,9,4
451,26,0,22,8,58.8,7,1
451,27,0,19,5,55.0,4,1
451,28,0,0,2,56.4,1,1
451,29,0,17,4,56.6,0,4
451,30,0,24,8,59.5,7,1
452,1,1,79,19,75.9,11,8
452,2,1,122,29,78.7,11,18
452,3,1,98,24,73.1,14,10
452,4,1,90,26,72.7,11,15
452,5,1,76,24,75.6,11,13
452,6,1,64,21,76.6,6,15
452,7,1,64,18,74.6,7,11
452,8,1,92,30,72.9,18,12
452,9,1,90,30,76.6,19,11
452,10,1,101,36,76.3,21,15
452,11,1,69,27,73.1,11,16
452,12,1,90,36,76.9,15,21
452,13,1,47,18,75.7,12,6
452,14,1,35,14,78.0,7,7
452,15,1,69,31,83.5,12,19
452,16,1,83,37,74.0,21,16
452,17,1,94,43,76.2,19,24
452,18,1,83,39,73.8,17,22
452,19,1,86,40,75.7,23,17
452,20,1,57,28,73.7,11,17
452,21,1,63,35,74.2,20,15
452,22,1,56,29,72.9,8,21
452,23,1,78,40,77.2,19,21
452,24,1,50,30,76.8,20,10
452,25,1,64,41,75.1,23,18
452,26,1,52,30,73.3,17,13
452,27,1,44,24,73.1,16,8
452,28,1,42,27,74.4,15,12
452,29,1,73,45,73.5,27,18
452,30,1,67,40,75.9,16,24
453,1,0,53,3,55.5,1,2
453,2,0,81,7,53.0,3,4
453,3,0,43,4,53.7,2,2
453,4,0,72,6,55.1,2,4
453,5,0,67,7,60.4,2,5
453,6,0,45,6,56.1,1,5
453,7,0,41,8,55.6,6,2
453,8,0,89,15,56.3,8,7
453,9,0,84,9,56.0,3,6
453,10,0,94,13,54.7,6,7
453,11,0,70,10,54.1,6,4
453,12,0,76,9,56.6,4,5
453,13,0,60,12,55.0,1,11
453,14,0,54,7,53.3,2,5
453,15,0,46,7,61.4,1,6
453,16,0,91,12,57.9,2,10
453,17,0,67,11,57.7,4,7
453,18,0,74,12,54.1,6,6
453,19,0,55,12,57.1,3,9
453,20,0,52,10,53.2,2,8
453,21,0,46,9,59.7,5,4
453,22,0,35,5,56.6,0,5
453,23,0,56,12,57.3,3,9
453,24,0,66,12,56.8,6,6
453,25,0,45,10,55.7,2,8
453,26,0,61,13,53.7,7,6
453,27,0,60,17,55.3,7,10
453,28,0,65,13,54.6,2,11
453,29,0,91,17,54.4,10,7
453,30,0,51,10,56.9,3,7
454,1,0,64,5,45.3,2,3
454,2,0,15,3,45.6,2,1
454,3,0,36,6,48.5,4,2
454,4,0,54,8,44.8,3,5
454,5,0,12,4,45.2,2,2
454,6,0,20,3,42.5,1,2
454,7,0,19,1,45.7,0,1
454,8,0,51,8,46.6,4,4
454,9,0,41,7,44.6,5,2
454,10,0,37,5,41.6,3,2
454,11,0,36,7,46.5,2,5
454,12,0,38,7,44.9,2,5
454,13,0,29,7,43.3,2,5
454,14,0,11,4,47.4,2,2
454,15,0,11,3,33.5,1,2
454,16,0,25,3,45.8,1,2
454,17,0,42,9,45.5,3,6
454,18,0,28,6,46.1,2,4
454,19,0,21,5,44.6,2,3
454,20,0,18,3,42.2,2,1
454,21,0,42,7,43.5,6,1
454,22,0,42,9,48.1,6,3
454,23,0,7,1,43.1,0,1
454,24,0,61,14,47.2,6,8
454,25,0,21,4,43.0,2,2
454,26,0,21,4,43.1,2,2
454,27,0,35,7,47.7,5,2
454,28,0,10,3,45.7,2,1
454,29,0,41,8,45.6,3,5
454,30,0,31,6,44.1,3,3
455,1,0,90,8,48.2,4,4
455,2,0,106,9,45.9,3,6
455,3,0,81,6,49.5,3,3
455,4,0,79,7,48.2,2,5
455,5,0,93,9,49.7,4,5
455,6,0,61,8,46.1,2,6
455,7,0,49,7,47.0,5,2
455,8,0,101,12,48.5,11,1
455,9,0,78,9,49.7,9,0
455,10,0,77,9,45.9,3,6
455,11,0,88,12,44.6,5,7
455,12,0,84,10,46.9,5,5
455,13,0,56,8,46.7,6,2
455,14,0,52,7,45.3,4,3
455,15,0,76,12,49.8,6,6
455,16,0,60,11,44.0,6,5
455,17,0,73,11,45.4,5,6
455,18,0,101,15,45.1,9,6
455,19,0,91,15,45.8,8,7
455,20,0,65,11,48.8,2,9
455,21,0,39,8,47.5,4,4
455,22,0,108,21,45.4,8,13
455,23,0,109,22,46.7,13,9
455,24,0,88,18,47.5,9,9
455,25,0,85,16,46.1,9,7
455,26,0,46,11,47.2,4,7
455,27,0,41,9,45.9,4,5
455,28,0,47,9,50.9,5,4
455,29,0,71,13,46.3,6,7
455,30,0,101,23,44.6,8,15
456,1,1,46,14,44.9,5,9
456,2,1,57,13,43.0,8,5
456,3,1,50,14,42.3,5,9
456,4,1,49,12,45.3,8,4
456,5,1,50,15,45.1,8,7
456,6,1,42,16,40.5,10,6
456,7,1,27,11,46.0,7,4
456,8,1,55,17,43.7,9,8
456,9,1,56,20,41.5,7,13
456,10,1,73,28,41.4,9,19
456,11,1,28,11,42.2,4,7
456,12,1,48,22,41.7,13,9
456,13,1,46,19,44.6,10,9
456,14,1,59,23,41.8,12,11
456,15,1,52,22,35.1,12,10
456,16,1,49,22,41.3,11,11
456,17,1,52,24,44.7,13,11
456,18,1,46,23,38.0,11,12
456,19,1,64,29,37.0,17,12
456,20,1,33,17,46.7,9,8
456,21,1,30,15,43.5,9,6
456,22,1,32,15,43.2,8,7
456,23,1,59,31,45.1,11,20
456,24,1,27,14,40.8,7,7
456,25,1,46,24,41.6,16,8
456,26,1,30,17,41.6,8,9
456,27,1,24,15,41.4,6,9
456,28,1,41,25,41.6,14,11
456,29,1,40,27,45.5,16,11
456,30,1,54,33,43.6,18,15
457,1,1,105,23,50.4,9,14
457,2,1,80,21,50.6,13,8
457,3,1,91,23,50.1,10,13
457,4,1,68,18,53.4,6,12
457,5,1,66,19,52.2,9,10
457,6,1,58,17,46.7,6,11
457,7,1,62,20,51.2,12,8
457,8,1,68,23,51.6,12,11
457,9,1,85,28,50.3,16,12
457,10,1,89,29,48.4,11,18
457,11,1,68,23,52.7,11,12
457,12,1,96,34,50.9,8,26
457,13,1,66,27,49.1,15,12
457,14,1,58,25,49.6,10,15
457,15,1,98,39,44.6,17,22
457,16,1,96,41,51.8,21,20
457,17,1,108,49,52.0,21,28
457,18,1,72,34,46.4,16,18
457,19,1,80,40,49.7,18,22
457,20,1,72,36,48.1,15,21
457,21,1,61,31,51.8,14,17
457,22,1,86,44,51.0,30,14
457,23,1,90,46,52.6,23,23
457,24,1,103,53,50.3,26,27
457,25,1,86,45,49.9,26,19
457,26,1,99,55,50.3,24,31
457,27,1,63,39,52.0,21,18
457,28,1,63,37,49.8,23,14
457,29,1,77,46,53.2,28,18
457,30,1,92,56,48.2,29,27
458,1,1,84,19,71.6,11,8
458,2,1,80,20,72.2,9,11
458,3,1,85,22,74.7,8,14
458,4,1,82,21,72.9,7,14
458,5,1,82,22,71.0,16,6
458,6,1,61,19,72.9,6,13
458,7,1,75,23,74.6,11,12
458,8,1,108,35,74.5,13,22
458,9,1,81,29,74.3,16,13
458,10,1,81,28,74.8,11,17
458,11,1,71,25,77.0,13,12
458,12,1,72,27,74.8,10,17
458,13,1,60,23,76.5,16,7
458,14,1,55,24,73.4,8,16
458,15,1,112,45,85.5,25,20
458,16,1,89,40,68.8,19,21
458,17,1,96,41,74.7,19,22
458,18,1,70,31,74.9,19,12
458,19,1,101,46,73.3,26,20
458,20,1,73,37,72.0,18,19
458,21,1,48,23,71.2,11,12
458,22,1,90,45,74.3,24,21
458,23,1,77,41,73.6,25,16
458,24,1,88,47,74.0,28,19
458,25,1,80,46,72.2,20,26
458,26,1,65,36,74.3,15,21
458,27,1,53,35,76.1,18,17
458,28,1,71,41,75.3,20,21
458,29,1,101,63,75.4,33,30
458,30,1,100,63,74.3,19,44
459,1,0,50,6,31.5,3,3
459,2,0,87,7,29.9,3,4
459,3,0,37,3,31.6,2,1
459,4,0,66,9,30.2,5,4
459,5,0,44,4,31.7,1,3
459,6,0,24,6,29.2,4,2
459,7,0,29,3,32.1,2,1
459,8,0,30,6,34.7,3,3
459,9,0,87,10,33.9,4,6
459,10,0,72,10,33.1,6,4
459,11,0,38,5,33.4,1,4
459,12,0,27,3,29.2,0,3
459,13,0,24,6,32.2,3,3
459,14,0,39,7,31.6,3,4
459,15,0,54,9,32.4,4,5
459,16,0,31,6,33.8,1,5
459,17,0,15,3,32.2,3,0
459,18,0,43,7,31.7,5,2
459,19,0,21,4,31.4,4,0
459,20,0,35,8,29.5,1,7
459,21,0,28,4,31.8,1,3
459,22,0,36,9,30.4,2,7
459,23,0,45,8,33.4,1,7
459,24,0,37,6,30.6,3,3
459,25,0,43,8,33.7,3,5
459,26,0,51,10,33.4,5,5
459,27,0,20,6,32.9,4,2
459,28,0,32,10,32.4,3,7
459,29,0,53,13,30.7,6,7
459,30,0,68,13,30.3,6,7
460,1,0,115,8,71.6,3,5
460,2,0,111,12,73.0,5,7
460,3,0,104,9,68.7,3,6
460,4,0,83,8,71.4,3,5
460,5,0,98,8,69.1,2,6
460,6,0,86,9,71.0,3,6
460,7,0,84,9,75.0,5,4
460,8,0,89,10,73.8,4,6
460,9,0,111,13,71.3,2,11
460,10,0,108,16,69.1,2,14
460,11,0,121,16,74.2,4,12
460,12,0,110,13,74.1,4,9
460,13,0,66,9,69.4,4,5
460,14,0,91,11,69.5,5,6
460,15,0,108,16,82.9,6,10
460,16,0,137,23,67.3,9,14
460,17,0,135,19,70.2,7,12
460,18,0,79,13,72.9,8,5
460,19,0,96,18,70.6,7,11
460,20,0,87,13,71.2,4,9
460,21,0,90,17,72.1,6,11
460,22,0,96,18,67.3,5,13
460,23,0,91,19,74.4,6,13
460,24,0,131,24,72.1,11,13
460,25,0,84,17,73.0,7,10
460,26,0,102,19,72.1,4,15
460,27,0,77,15,73.4,4,11
460,28,0,71,17,71.9,5,12
460,29,0,114,23,72.3,5,18
460,30,0,98,22,71.5,8,14
461,1,0,78,5,35.0,3,2
461,2,0,72,5,34.2,3,2
461,3,0,90,9,34.4,2,7
461,4,0,42,6,35.0,4,2
461,5,0,90,10,35.6,5,5
461,6,0,66,7,34.5,3,4
461,7,0,67,7,32.9,3,4
461,8,0,75,10,36.3,8,2
461,9,0,74,10,32.7,5,5
461,10,0,89,10,36.2,4,6
461,11,0,73,10,35.4,5,5
461,12,0,55,6,34.0,3,3
461,13,0,85,12,36.3,8,4
461,14,0,50,9,34.6,2,7
461,15,0,92,12,25.4,4,8
461,16,0,63,10,32.2,4,6
461,17,0,55,8,32.6,5,3
461,18,0,83,14,39.7,5,9
461,19,0,69,13,32.1,10,3
461,20,0,72,13,30.7,9,4
461,21,0,61,10,32.9,4,6
461,22,0,76,13,34.3,6,7
461,23,0,97,18,32.7,9,9
461,24,0,104,20,31.9,12,8
461,25,0,90,16,37.4,8,8
461,26,0,69,12,38.0,5,7
461,27,0,77,16,35.8,9,7
461,28,0,64,16,34.9,7,9
461,29,0,60,14,31.8,6,8
461,30,0,77,17,37.1,9,8
462,1,0,101,10,39.2,6,4
462,2,0,71,8,37.3,5,3
462,3,0,117,9,38.4,5,4
462,4,0,83,8,33.7,5,3
462,5,0,79,9,39.9,4,5
462,6,0,64,5,36.5,2,3
462,7,0,56,6,35.8,4,2
462,8,0,120,16,36.8,10,6
462,9,0,104,13,40.6,6,7
462,10,0,90,12,38.8,7,5
462,11,0,102,13,33.4,5,8
462,12,0,90,16,40.2,8,8
462,13,0,72,10,38.0,2,8
462,14,0,50,6,36.0,4,2
462,15,0,77,11,32.1,5,6
462,16,0,90,12,38.9,7,5
462,17,0,61,9,39.0,6,3
462,18,0,90,15,40.5,7,8
462,19,0,88,19,36.7,9,10
462,20,0,81,12,34.0,4,8
462,21,0,70,12,38.5,7,5
462,22,0,70,12,36.9,7,5
462,23,0,95,18,38.8,12,6
462,24,0,121,22,37.9,9,13
462,25,0,118,21,39.6,10,11
462,26,0,102,22,37.9,12,10
462,27,0,57,12,37.5,6,6
462,28,0,63,13,38.2,8,5
462,29,0,58,15,35.8,8,7
462,30,0,80,17,38.3,12,5
463,1,0,42,6,36.2,4,2
463,2,0,45,9,38.3,7,2
463,3,0,35,7,34.7,5,2
463,4,0,44,3,35.9,0,3
463,5,0,44,6,35.1,4,2
463,6,0,32,4,36.7,4,0
463,7,0,20,6,37.6,4,2
463,8,0,56,7,35.4,4,3
463,9,0,35,5,35.3,4,1
463,10,0,17,5,37.5,3,2
463,11,0,70,12,35.9,9,3
463,12,0,50,7,34.0,7,0
463,13,0,20,4,37.6,2,2
463,14,0,33,7,36.7,5,2
463,15,0,23,7,31.5,6,1
463,16,0,67,12,36.4,9,3
463,17,0,40,6,35.3,6,0
463,18,0,14,3,36.2,2,1
463,19,0,33,6,34.8,3,3
463,20,0,36,6,33.8,5,1
463,21,0,26,4,34.3,2,2
463,22,0,31,9,35.1,4,5
463,23,0,32,6,37.8,4,2
463,24,0,14,4,32.6,2,2
463,25,0,21,6,33.8,3,3
463,26,0,9,3,32.1,2,1
463,27,0,33,6,34.5,5,1
463,28,0,27,11,34.6,8,3
463,29,0,3,3,33.5,1,2
463,30,0,6,3,35.6,0,3
464,1,0,50,6,61.1,5,1
464,2,0,59,8,66.1,6,2
464,3,0,29,2,65.4,0,2
464,4,0,50,5,62.4,4,1
464,5,0,43,5,69.6,3,2
464,6,0,33,5,64.9,2,3
464,7,0,19,4,60.7,1,3
464,8,0,34,4,67.2,2,2
464,9,0,52,9,62.6,7,2
464,10,0,49,6,65.9,4,2
464,11,0,42,6,64.6,3,3
464,12,0,43,6,63.6,3,3
464,13,0,30,6,62.4,4,2
464,14,0,42,8,64.3,4,4
464,15,0,76,16,57.9,11,5
464,16,0,65,10,62.4,9,1
464,17,0,49,6,62.2,5,1
464,18,0,59,8,65.8,5,3
464,19,0,44,10,66.6,5,5
464,20,0,36,6,63.9,3,3
464,21,0,36,8,63.2,5,3
464,22,0,59,10,59.8,8,2
464,23,0,57,10,65.3,6,4
464,24,0,67,16,63.7,15,1
464,25,0,85,15,63.7,13,2
464,26,0,40,11,64.2,10,1
464,27,0,42,10,65.8,6,4
464,28,0,42,9,64.7,5,4
464,29,0,29,5,64.9,5,0
464,30,0,27,5,65.1,0,5
465,1,0,140,12,81.3,6,6
465,2,0,108,11,73.6,4,7
465,3,0,100,8,74.8,4,4
465,4,0,137,14,75.7,6,8
465,5,0,114,10,74.4,4,6
465,6,0,72,11,75.5,4,7
465,7,0,72,8,73.0,5,3
465,8,0,97,11,79.1,6,5
465,9,0,97,12,77.3,3,9
465,10,0,103,12,76.1,9,3
465,11,0,109,13,75.6,7,6
465,12,0,122,15,74.2,10,5
465,13,0,83,11,76.2,6,5
465,14,0,74,13,76.9,5,8
465,15,0,94,13,73.8,6,7
465,16,0,93,12,73.9,8,4
465,17,0,79,14,71.5,8,6
465,18,0,109,19,78.5,8,11
465,19,0,76,12,79.2,7,5
465,20,0,82,14,72.6,6,8
465,21,0,87,16,76.0,10,6
465,22,0,106,19,73.1,7,12
465,23,0,103,18,74.1,9,9
465,24,0,111,24,74.0,14,10
465,25,0,134,27,74.9,19,8
465,26,0,102,19,71.8,11,8
465,27,0,82,16,75.1,7,9
465,28,0,69,16,76.0,6,10
465,29,0,110,23,73.5,11,12
465,30,0,105,27,74.5,20,7
466,1,0,100,8,69.2,5,3
466,2,0,69,7,67.6,3,4
466,3,0,104,9,72.8,4,5
466,4,0,68,7,68.0,5,2
466,5,0,89,10,67.9,6,4
466,6,0,67,7,70.3,6,1
466,7,0,64,9,71.5,7,2
466,8,0,83,9,68.8,7,2
466,9,0,62,6,67.8,5,1
466,10,0,74,12,67.5,8,4
466,11,0,66,10,65.7,7,3
466,12,0,76,16,69.3,14,2
466,13,0,64,8,69.2,5,3
466,14,0,59,8,68.7,6,2
466,15,0,94,16,64.1,7,9
466,16,0,120,17,69.2,10,7
466,17,0,88,15,66.2,8,7
466,18,0,85,15,72.0,12,3
466,19,0,108,18,69.5,11,7
466,20,0,56,11,70.3,8,3
466,21,0,54,9,67.3,6,3
466,22,0,84,14,69.0,11,3
466,23,0,94,18,70.1,11,7
466,24,0,88,17,70.9,9,8
466,25,0,90,16,69.4,10,6
466,26,0,97,17,70.2,13,4
466,27,0,72,14,65.4,8,6
466,28,0,76,15,70.6,11,4
466,29,0,81,15,67.3,7,8
466,30,0,87,21,69.8,16,5
467,1,0,3,0,68.3,0,0
467,2,0,15,4,65.5,2,2
467,3,0,0,2,65.7,1,1
467,4,0,30,3,67.1,1,2
467,5,0,5,3,68.1,2,1
467,6,0,10,3,68.7,1,2
467,7,0,4,2,68.4,0,2
467,8,0,6,1,66.6,1,0
467,9,0,20,5,68.6,1,4
467,10,0,19,4,66.8,2,2
467,11,0,1,4,63.4,0,4
467,12,0,60,8,70.9,3,5
467,13,0,0,1,67.4,1,0
467,14,0,5,0,68.1,0,0
467,15,0,7,6,75.0,4,2
467,16,0,0,4,67.8,1,3
467,17,0,25,6,66.7,3,3
467,18,0,0,1,65.1,0,1
467,19,0,0,1,67.9,1,0
467,20,0,21,5,63.1,2,3
467,21,0,1,3,66.5,1,2
467,22,0,16,4,67.5,1,3
467,23,0,13,4,70.2,2,2
467,24,0,24,8,66.7,2,6
467,25,0,28,5,71.0,0,5
467,26,0,12,3,69.3,0,3
467,27,0,19,6,66.2,3,3
467,28,0,0,2,71.1,1,1
467,29,0,18,6,73.5,3,3
467,30,0,19,3,67.4,1,2
468,1,0,116,9,51.3,5,4
468,2,0,108,9,51.0,1,8
468,3,0,99,8,50.6,5,3
468,4,0,85,9,50.8,3,6
468,5,0,114,12,54.2,6,6
468,6,0,61,8,49.4,1,7
468,7,0,70,7,48.8,4,3
468,8,0,107,11,49.4,4,7
468,9,0,108,14,53.0,8,6
468,10,0,123,16,48.4,10,6
468,11,0,124,14,51.2,4,10
468,12,0,90,12,56.1,7,5
468,13,0,83,11,51.4,4,7
468,14,0,92,13,49.1,4,9
468,15,0,77,16,46.1,4,12
468,16,0,99,14,53.1,5,9
468,17,0,121,21,49.0,5,16
468,18,0,99,15,52.8,6,9
468,19,0,90,15,52.3,7,8
468,20,0,80,14,49.3,4,10
468,21,0,65,10,52.7,3,7
468,22,0,125,23,53.4,8,15
468,23,0,101,18,51.4,9,9
468,24,0,119,25,46.6,10,15
468,25,0,100,19,50.3,4,15
468,26,0,103,20,52.3,11,9
468,27,0,73,15,49.3,2,13
468,28,0,74,17,51.0,7,10
468,29,0,106,21,48.5,6,15
468,30,0,135,30,49.0,7,23
469,1,1,94,22,50.7,11,11
469,2,1,70,17,49.0,9,8
469,3,1,85,22,53.6,14,8
469,4,1,44,12,51.3,2,10
469,5,1,57,18,52.0,7,11
469,6,1,56,18,55.0,10,8
469,7,1,39,13,53.2,7,6
469,8,1,63,23,53.3,13,10
469,9,1,71,24,52.0,14,10
469,10,1,80,27,50.0,15,12
469,11,1,51,19,48.6,8,11
469,12,1,71,26,51.4,15,11
469,13,1,27,10,51.4,5,5
469,14,1,50,19,48.7,9,10
469,15,1,64,27,49.5,16,11
469,16,1,60,27,55.7,15,12
469,17,1,87,39,54.1,20,19
469,18,1,74,34,51.4,12,22
469,19,1,43,20,52.4,10,10
469,20,1,51,24,50.5,7,17
469,21,1,42,21,52.1,9,12
469,22,1,75,37,52.0,22,15
469,23,1,79,41,52.1,24,17
469,24,1,65,37,53.8,14,23
469,25,1,35,20,51.8,12,8
469,26,1,91,53,51.2,26,27
469,27,1,49,27,53.5,17,10
469,28,1,57,35,50.7,11,24
469,29,1,66,41,54.7,28,13
469,30,1,78,49,51.9,18,31
470,1,0,50,5,69.8,3,2
470,2,0,59,9,67.6,5,4
470,3,0,35,4,70.9,3,1
470,4,0,53,4,70.2,3,1
470,5,0,44,6,70.9,5,1
470,6,0,19,3,72.8,3,0
470,7,0,41,6,68.2,1,5
470,8,0,29,3,68.1,3,0
470,9,0,42,7,66.2,5,2
470,10,0,55,7,68.3,6,1
470,11,0,18,3,68.6,1,2
470,12,0,30,3,68.1,2,1
470,13,0,21,3,74.4,2,1
470,14,0,35,5,69.2,4,1
470,15,0,54,10,70.6,8,2
470,16,0,42,5,69.0,4,1
470,17,0,63,12,69.2,7,5
470,18,0,18,4,67.5,1,3
470,19,0,29,8,68.6,6,2
470,20,0,20,6,72.5,4,2
470,21,0,20,3,69.9,3,0
470,22,0,22,3,67.1,2,1
470,23,0,49,11,68.9,8,3
470,24,0,27,8,71.0,4,4
470,25,0,30,7,66.0,6,1
470,26,0,9,3,69.1,3,0
470,27,0,29,7,66.4,3,4
470,28,0,24,4,71.1,1,3
470,29,0,11,3,68.7,2,1
470,30,0,29,7,70.2,5,2
471,1,0,44,4,49.7,2,2
471,2,0,43,4,47.8,1,3
471,3,0,51,5,49.2,1,4
471,4,0,34,4,49.3,1,3
471,5,0,60,5,45.9,1,4
471,6,0,31,5,53.0,2,3
471,7,0,35,6,50.1,2,4
471,8,0,32,4,52.0,2,2
471,9,0,47,6,50.4,1,5
471,10,0,60,8,52.3,3,5
471,11,0,55,8,47.7,2,6
471,12,0,42,7,51.6,3,4
471,13,0,44,5,46.9,0,5
471,14,0,32,5,48.2,2,3
471,15,0,40,5,58.3,3,2
471,16,0,33,5,52.2,0,5
471,17,0,57,11,47.7,5,6
471,18,0,27,5,47.2,2,3
471,19,0,49,9,49.1,3,6
471,20,0,25,4,49.4,0,4
471,21,0,36,6,45.1,3,3
471,22,0,43,7,52.4,5,2
471,23,0,62,12,49.6,4,8
471,24,0,59,12,46.3,5,7
471,25,0,21,5,50.8,1,4
471,26,0,45,9,49.9,4,5
471,27,0,33,10,49.9,3,7
471,28,0,26,5,46.2,1,4
471,29,0,48,12,47.2,6,6
471,30,0,55,13,48.7,7,6
472,1,1,66,15,61.4,7,8
472,2,1,57,15,62.6,7,8
472,3,1,62,18,61.3,8,10
472,4,1,54,15,61.7,7,8
472,5,1,74,20,63.4,9,11
472,6,1,36,11,62.0,4,7
472,7,1,35,11,59.5,4,7
472,8,1,74,24,61.7,12,12
472,9,1,80,25,58.7,18,7
472,10,1,68,26,60.8,13,13
472,11,1,65,25,59.3,11,14
472,12,1,48,18,59.8,8,10
472,13,1,40,15,60.8,8,7
472,14,1,45,18,61.6,8,10
472,15,1,70,28,61.1,17,11
472,16,1,53,22,59.2,14,8
472,17,1,60,28,60.5,8,20
472,18,1,53,24,62.2,13,11
472,19,1,37,17,62.8,9,8
472,20,1,36,19,61.0,12,7
472,21,1,51,24,61.0,11,13
472,22,1,58,30,58.5,15,15
472,23,1,77,39,60.7,13,26
472,24,1,60,34,58.3,16,18
472,25,1,75,45,60.0,18,27
472,26,1,48,28,59.7,15,13
472,27,1,51,29,59.2,14,15
472,28,1,42,26,59.2,11,15
472,29,1,56,32,63.5,18,14
472,30,1,51,30,57.9,8,22
473,1,1,59,17,79.1,11,6
473,2,1,72,21,79.0,13,8
473,3,1,61,16,77.4,5,11
473,4,1,59,16,76.9,8,8
473,5,1,74,22,76.4,13,9
473,6,1,38,11,78.7,4,7
473,7,1,47,13,81.0,8,5
473,8,1,61,19,80.5,13,6
473,9,1,71,24,75.4,17,7
473,10,1,51,18,78.9,10,8
473,11,1,51,19,77.8,6,13
473,12,1,58,23,80.6,11,12
473,13,1,39,17,79.0,11,6
473,14,1,55,24,79.5,13,11
473,15,1,103,44,70.6,26,18
473,16,1,66,28,77.3,8,20
473,17,1,64,28,78.6,17,11
473,18,1,74,33,81.0,17,16
473,19,1,80,37,78.7,12,25
473,20,1,26,17,76.9,5,12
473,21,1,37,22,80.4,11,11
473,22,1,78,41,76.5,21,20
473,23,1,77,39,74.8,15,24
473,24,1,54,31,77.9,11,20
473,25,1,65,35,79.3,15,20
473,26,1,60,32,75.8,17,15
473,27,1,45,29,75.9,13,16
473,28,1,59,34,78.7,22,12
473,29,1,66,43,78.7,24,19
473,30,1,66,41,81.2,23,18
474,1,0,50,5,39.6,1,4
474,2,0,77,6,37.1,2,4
474,3,0,54,5,38.5,2,3
474,4,0,78,9,42.3,4,5
474,5,0,41,4,38.5,1,3
474,6,0,51,5,36.4,2,3
474,7,0,39,6,34.1,1,5
474,8,0,55,6,37.4,3,3
474,9,0,68,9,36.2,2,7
474,10,0,76,10,33.7,4,6
474,11,0,70,10,38.7,7,3
474,12,0,52,7,37.2,1,6
474,13,0,36,7,37.6,0,7
474,14,0,50,10,38.5,3,7
474,15,0,74,12,36.1,4,8
474,16,0,66,10,35.0,3,7
474,17,0,68,13,41.2,6,7
474,18,0,60,10,41.9,2,8
474,19,0,98,16,39.1,7,9
474,20,0,64,10,36.5,1,9
474,21,0,32,10,37.2,5,5
474,22,0,57,11,40.2,1,10
474,23,0,75,13,37.8,4,9
474,24,0,79,13,38.0,8,5
474,25,0,59,12,40.2,2,10
474,26,0,76,15,35.8,8,7
474,27,0,44,8,41.8,5,3
474,28,0,61,13,38.7,4,9
474,29,0,71,16,35.6,5,11
474,30,0,88,21,35.1,8,13
475,1,1,27,8,68.9,4,4
475,2,1,15,7,68.1,2,5
475,3,1,10,4,69.8,1,3
475,4,1,20,7,67.6,1,6
475,5,1,19,8,70.1,3,5
475,6,1,2,2,73.5,0,2
475,7,1,14,6,70.4,3,3
475,8,1,27,10,69.8,4,6
475,9,1,0,1,72.3,1,0
475,10,1,6,4,64.0,1,3
475,11,1,20,8,73.1,3,5
475,12,1,16,6,65.0,2,4
475,13,1,5,5,70.5,3,2
475,14,1,20,7,68.8,3,4
475,15,1,21,8,59.2,3,5
475,16,1,0,0,71.8,0,0
475,17,1,0,2,68.1,1,1
475,18,1,9,3,69.8,2,1
475,19,1,42,23,71.9,14,9
475,20,1,6,2,71.6,0,2
475,21,1,11,6,69.4,2,4
475,22,1,5,4,70.5,0,4
475,23,1,18,11,71.1,5,6
475,24,1,6,3,70.2,1,2
475,25,1,1,1,69.0,1,0
475,26,1,13,10,68.6,3,7
475,27,1,12,9,69.3,4,5
475,28,1,3,1,69.5,0,1
475,29,1,36,23,71.7,8,15
475,30,1,15,12,71.4,8,4
476,1,1,46,10,77.4,2,8
476,2,1,42,11,74.1,5,6
476,3,1,45,13,78.3,9,4
476,4,1,26,9,75.8,4,5
476,5,1,25,7,78.8,2,5
476,6,1,12,5,79.9,2,3
476,7,1,39,13,78.5,3,10
476,8,1,43,16,77.3,10,6
476,9,1,22,8,79.9,4,4
476,10,1,38,16,76.0,11,5
476,11,1,42,18,76.9,8,10
476,12,1,34,14,78.9,7,7
476,13,1,28,10,76.1,5,5
476,14,1,20,9,79.5,1,8
476,15,1,71,33,68.2,15,18
476,16,1,51,26,78.4,9,17
476,17,1,47,20,79.5,7,13
476,18,1,18,8,75.6,5,3
476,19,1,33,16,76.0,12,4
476,20,1,13,8,78.1,6,2
476,21,1,23,13,78.2,8,5
476,22,1,37,18,75.7,12,6
476,23,1,44,25,76.3,9,16
476,24,1,25,15,76.3,11,4
476,25,1,45,24,78.6,15,9
476,26,1,20,13,77.0,5,8
476,27,1,28,15,75.8,13,2
476,28,1,42,24,73.1,12,12
476,29,1,30,17,79.6,11,6
476,30,1,35,22,75.8,8,14
477,1,1,119,28,54.4,11,17
477,2,1,52,11,56.6,6,5
477,3,1,93,24,60.4,11,13
477,4,1,92,26,60.1,11,15
477,5,1,88,26,61.3,14,12
477,6,1,53,17,60.6,6,11
477,7,1,48,15,56.7,7,8
477,8,1,93,29,55.7,22,7
477,9,1,78,27,56.5,8,19
477,10,1,60,22,58.0,8,14
477,11,1,46,16,53.4,6,10
477,12,1,100,37,58.2,17,20
477,13,1,56,23,56.7,11,12
477,14,1,59,23,58.1,8,15
477,15,1,67,27,47.2,16,11
477,16,1,77,35,60.6,15,20
477,17,1,59,29,58.3,18,11
477,18,1,74,35,59.9,17,18
477,19,1,77,36,58.4,21,15
477,20,1,44,22,55.5,5,17
477,21,1,54,29,57.6,14,15
477,22,1,94,49,59.4,32,17
477,23,1,57,30,60.5,18,12
477,24,1,93,51,61.0,29,22
477,25,1,75,41,60.7,20,21
477,26,1,63,37,59.8,22,15
477,27,1,51,30,56.9,16,14
477,28,1,43,24,60.4,12,12
477,29,1,69,41,58.1,24,17
477,30,1,75,48,60.8,30,18
478,1,0,32,6,69.1,5,1
478,2,0,28,6,66.6,4,2
478,3,0,54,6,64.9,4,2
478,4,0,52,4,68.2,4,0
478,5,0,33,3,72.6,3,0
478,6,0,22,3,68.6,1,2
478,7,0,27,5,68.2,3,2
478,8,0,42,7,66.4,3,4
478,9,0,10,2,71.3,2,0
478,10,0,48,6,67.9,2,4
478,11,0,41,4,71.5,4,0
478,12,0,78,12,67.2,8,4
478,13,0,8,3,67.1,2,1
478,14,0,38,5,71.3,2,3
478,15,0,35,6,74.1,3,3
478,16,0,40,8,69.0,5,3
478,17,0,0,1,67.5,1,0
478,18,0,41,8,68.2,5,3
478,19,0,27,5,68.1,3,2
478,20,0,29,4,73.7,3,1
478,21,0,20,5,69.9,3,2
478,22,0,33,5,68.1,2,3
478,23,0,39,8,67.3,6,2
478,24,0,37,6,68.6,5,1
478,25,0,42,8,69.0,8,0
478,26,0,38,8,71.8,3,5
478,27,0,41,8,70.0,7,1
478,28,0,7,2,72.3,2,0
478,29,0,61,13,70.7,10,3
478,30,0,31,10,69.0,6,4
479,1,0,31,3,51.1,1,2
479,2,0,42,4,54.3,2,2
479,3,0,35,3,49.2,1,2
479,4,0,60,7,50.1,4,3
479,5,0,16,5,49.3,3,2
479,6,0,35,6,49.9,3,3
479,7,0,32,3,49.4,2,1
479,8,0,40,6,55.8,1,5
479,9,0,40,7,55.5,3,4
479,10,0,32,4,48.5,2,2
479,11,0,45,5,49.4,2,3
479,12,0,23,4,50.0,2,2
479,13,0,10,2,50.9,0,2
479,14,0,17,3,52.2,1,2
479,15,0,43,7,52.9,2,5
479,16,0,25,4,48.8,1,3
479,17,0,34,6,48.7,2,4
479,18,0,54,10,52.8,2,8
479,19,0,53,8,47.3,0,8
479,20,0,32,5,49.8,3,2
479,21,0,3,3,50.1,1,2
479,22,0,39,7,51.8,0,7
479,23,0,32,5,52.0,2,3
479,24,0,31,5,51.4,2,3
479,25,0,51,10,49.1,5,5
479,26,0,39,9,49.3,6,3
479,27,0,30,6,50.8,3,3
479,28,0,37,8,49.0,3,5
479,29,0,9,3,50.3,1,2
479,30,0,33,8,52.0,2,6
480,1,0,80,6,24.8,2,4
480,2,0,81,8,28.1,5,3
480,3,0,107,8,30.6,6,2
480,4,0,88,9,26.6,8,1
480,5,0,49,4,24.1,2,2
480,6,0,65,7,26.6,6,1
480,7,0,61,5,25.1,4,1
480,8,0,102,14,24.1,12,2
480,9,0,52,6,26.5,5,1
480,10,0,101,12,27.9,6,6
480,11,0,79,9,25.6,6,3
480,12,0,62,10,29.2,9,1
480,13,0,61,8,27.5,5,3
480,14,0,66,12,29.0,9,3
480,15,0,70,9,28.1,5,4
480,16,0,86,13,24.0,8,5
480,17,0,84,12,25.4,8,4
480,18,0,77,12,24.2,7,5
480,19,0,110,17,25.6,11,6
480,20,0,42,9,26.8,9,0
480,21,0,59,10,27.0,6,4
480,22,0,65,13,24.8,5,8
480,23,0,70,13,27.7,12,1
480,24,0,86,14,23.0,10,4
480,25,0,81,16,26.6,11,5
480,26,0,82,14,27.5,11,3
480,27,0,53,10,26.1,5,5
480,28,0,77,15,25.0,13,2
480,29,0,98,20,25.2,11,9
480,30,0,53,14,28.0,7,7
481,1,0,29,3,76.0,0,3
481,2,0,0,3,72.0,2,1
481,3,0,11,3,77.2,1,2
481,4,0,41,7,73.3,3,4
481,5,0,36,4,72.1,2,2
481,6,0,8,2,74.3,2,0
481,7,0,20,6,77.3,1,5
481,8,0,10,2,74.0,0,2
481,9,0,2,0,73.8,0,0
481,10,0,23,3,78.3,2,1
481,11,0,19,4,78.7,1,3
481,12,0,41,7,72.2,4,3
481,13,0,0,4,77.6,3,1
481,14,0,0,4,74.2,3,1
481,15,0,36,5,75.7,3,2
481,16,0,1,1,70.8,0,1
481,17,0,19,4,76.7,3,1
481,18,0,0,0,72.8,0,0
481,19,0,0,0,75.7,0,0
481,20,0,12,2,73.6,2,0
481,21,0,16,5,75.0,0,5
481,22,0,7,1,77.0,1,0
481,23,0,15,4,74.1,0,4
481,24,0,18,3,79.2,1,2
481,25,0,6,3,76.3,1,2
481,26,0,3,3,71.7,0,3
481,27,0,8,1,76.9,1,0
481,28,0,23,5,73.3,2,3
481,29,0,0,0,77.6,0,0
481,30,0,12,5,70.9,3,2
482,1,0,60,8,54.9,6,2
482,2,0,83,6,55.5,3,3
482,3,0,74,8,54.0,4,4
482,4,0,58,5,56.1,4,1
482,5,0,48,7,52.9,5,2
482,6,0,57,5,56.4,1,4
482,7,0,63,9,61.1,4,5
482,8,0,91,9,58.2,7,2
482,9,0,61,8,55.8,8,0
482,10,0,58,9,56.4,6,3
482,11,0,94,14,57.3,10,4
482,12,0,75,10,55.2,7,3
482,13,0,18,4,54.6,3,1
482,14,0,34,11,56.0,6,5
482,15,0,66,12,58.4,8,4
482,16,0,48,8,53.8,5,3
482,17,0,45,8,57.7,6,2
482,18,0,51,9,57.0,4,5
482,19,0,60,11,56.8,7,4
482,20,0,55,9,56.4,5,4
482,21,0,51,8,55.3,7,1
482,22,0,76,15,54.6,8,7
482,23,0,65,11,54.6,7,4
482,24,0,88,16,54.5,7,9
482,25,0,85,17,56.2,12,5
482,26,0,60,13,53.0,9,4
482,27,0,45,11,57.1,7,4
482,28,0,60,14,53.5,7,7
482,29,0,87,19,53.2,12,7
482,30,0,55,12,55.4,9,3
483,1,0,122,10,63.8,10,0
483,2,0,123,10,61.2,6,4
483,3,0,87,6,61.1,4,2
483,4,0,73,6,60.6,2,4
483,5,0,84,9,59.6,6,3
483,6,0,68,7,65.1,6,1
483,7,0,65,7,59.7,5,2
483,8,0,114,11,62.8,9,2
483,9,0,83,13,60.0,8,5
483,10,0,77,12,59.6,8,4
483,11,0,120,13,58.5,9,4
483,12,0,96,12,62.2,7,5
483,13,0,66,11,64.4,9,2
483,14,0,75,10,60.3,8,2
483,15,0,106,14,58.2,9,5
483,16,0,95,13,58.5,7,6
483,17,0,70,13,60.0,9,4
483,18,0,95,14,62.7,7,7
483,19,0,104,18,62.5,13,5
483,20,0,68,13,63.7,9,4
483,21,0,78,13,63.1,4,9
483,22,0,113,21,64.1,17,4
483,23,0,97,18,62.0,9,9
483,24,0,101,19,62.9,15,4
483,25,0,79,18,61.8,11,7
483,26,0,85,17,66.3,12,5
483,27,0,60,15,58.5,10,5
483,28,0,74,14,64.2,8,6
483,29,0,104,23,61.3,18,5
483,30,0,73,17,61.3,11,6
484,1,0,103,8,72.3,2,6
484,2,0,104,11,74.9,6,5
484,3,0,102,8,69.7,2,6
484,4,0,115,10,69.2,9,1
484,5,0,86,11,70.4,5,6
484,6,0,65,7,73.6,3,4
484,7,0,73,7,71.3,5,2
484,8,0,110,12,70.8,4,8
484,9,0,94,11,69.9,7,4
484,10,0,91,11,70.8,5,6
484,11,0,104,14,74.7,8,6
484,12,0,115,16,68.5,6,10
484,13,0,67,11,75.7,7,4
484,14,0,100,16,71.8,6,10
484,15,0,111,15,70.3,10,5
484,16,0,100,15,73.0,12,3
484,17,0,105,16,70.7,6,10
484,18,0,107,17,69.3,8,9
484,19,0,117,19,70.8,10,9
484,20,0,70,11,74.2,4,7
484,21,0,76,13,70.8,4,9
484,22,0,118,21,71.6,13,8
484,23,0,104,19,70.3,9,10
484,24,0,108,18,72.4,11,7
484,25,0,113,23,73.2,8,15
484,26,0,125,25,71.6,12,13
484,27,0,77,15,68.1,7,8
484,28,0,67,14,70.3,5,9
484,29,0,115,25,74.5,12,13
484,30,0,107,22,69.1,14,8
485,1,1,0,0,40.5,0,0
485,2,1,6,6,40.5,5,1
485,3,1,39,10,40.8,5,5
485,4,1,4,1,37.0,1,0
485,5,1,39,10,37.2,6,4
485,6,1,11,7,42.9,2,5
485,7,1,18,5,38.0,4,1
485,8,1,31,11,38.1,8,3
485,9,1,10,5,36.6,2,3
485,10,1,23,7,38.5,5,2
485,11,1,13,4,38.8,2,2
485,12,1,0,0,36.9,0,0
485,13,1,5,4,42.2,1,3
485,14,1,8,5,36.8,2,3
485,15,1,29,12,35.5,8,4
485,16,1,20,9,39.5,6,3
485,17,1,29,15,39.3,7,8
485,18,1,26,14,34.3,7,7
485,19,1,0,1,35.3,0,1
485,20,1,16,8,39.5,6,2
485,21,1,15,12,38.8,6,6
485,22,1,18,9,38.3,3,6
485,23,1,22,12,37.9,2,10
485,24,1,37,22,36.5,9,13
485,25,1,0,0,40.2,0,0
485,26,1,15,12,39.2,9,3
485,27,1,11,7,33.8,4,3
485,28,1,18,11,41.4,5,6
485,29,1,8,6,41.3,3,3
485,30,1,23,15,39.8,9,6
486,1,0,68,6,72.2,4,2
486,2,0,33,2,74.6,1,1
486,3,0,61,6,66.7,3,3
486,4,0,64,12,70.4,5,7
486,5,0,53,6,70.0,2,4
486,6,0,51,6,72.5,1,5
486,7,0,59,6,71.4,3,3
486,8,0,72,8,71.3,3,5
486,9,0,70,9,74.8,2,7
486,10,0,48,6,65.7,0,6
486,11,0,73,10,70.7,3,7
486,12,0,64,11,69.4,4,7
486,13,0,48,9,72.5,4,5
486,14,0,46,7,70.4,3,4
486,15,0,71,11,77.8,3,8
486,16,0,89,14,73.1,2,12
486,17,0,99,15,68.1,7,8
486,18,0,76,12,71.5,4,8
486,19,0,49,8,69.3,3,5
486,20,0,44,10,72.6,3,7
486,21,0,50,9,73.5,3,6
486,22,0,77,15,75.0,10,5
486,23,0,64,12,72.4,5,7
486,24,0,101,20,70.4,7,13
486,25,0,63,13,72.0,4,9
486,26,0,72,15,70.1,5,10
486,27,0,54,12,72.4,3,9
486,28,0,43,9,70.5,2,7
486,29,0,74,14,74.4,8,6
486,30,0,67,18,68.0,6,12
487,1,1,41,8,75.4,2,6
487,2,1,71,17,77.0,13,4
487,3,1,24,8,76.8,3,5
487,4,1,59,19,75.4,7,12
487,5,1,86,24,75.0,12,12
487,6,1,31,9,74.9,4,5
487,7,1,17,5,77.2,5,0
487,8,1,62,21,78.9,10,11
487,9,1,35,12,76.2,6,6
487,10,1,35,14,74.0,9,5
487,11,1,28,10,75.9,5,5
487,12,1,48,18,71.3,5,13
487,13,1,34,14,75.7,6,8
487,14,1,19,10,76.7,4,6
487,15,1,38,16,79.5,6,10
487,16,1,39,16,78.4,9,7
487,17,1,39,18,76.3,11,7
487,18,1,56,25,76.3,13,12
487,19,1,35,18,77.6,11,7
487,20,1,36,17,78.3,9,8
487,21,1,31,15,79.5,11,4
487,22,1,40,21,76.0,11,10
487,23,1,49,26,75.2,16,10
487,24,1,55,30,73.1,12,18
487,25,1,41,22,77.7,6,16
487,26,1,30,19,77.0,7,12
487,27,1,21,13,75.6,8,5
487,28,1,26,16,77.0,10,6
487,29,1,52,32,75.5,16,16
487,30,1,12,7,75.5,4,3
488,1,0,34,5,35.2,3,2
488,2,0,50,6,34.3,4,2
488,3,0,52,7,36.8,4,3
488,4,0,22,1,34.0,1,0
488,5,0,16,3,35.1,1,2
488,6,0,4,2,36.7,1,1
488,7,0,11,3,38.6,2,1
488,8,0,19,1,38.3,1,0
488,9,0,32,4,35.1,2,2
488,10,0,51,8,36.3,6,2
488,11,0,32,4,34.6,1,3
488,12,0,32,6,36.1,3,3
488,13,0,25,7,40.0,4,3
488,14,0,43,7,34.3,6,1
488,15,0,31,10,19.7,6,4
488,16,0,47,8,33.3,7,1
488,17,0,62,9,33.0,8,1
488,18,0,39,9,37.9,9,0
488,19,0,31,5,36.8,4,1
488,20,0,30,5,35.4,2,3
488,21,0,22,4,35.8,4,0
488,22,0,42,7,35.2,5,2
488,23,0,29,6,35.6,4,2
488,24,0,45,8,34.4,3,5
488,25,0,55,9,35.8,5,4
488,26,0,48,10,37.7,5,5
488,27,0,35,8,36.6,5,3
488,28,0,55,14,37.5,8,6
488,29,0,37,8,32.1,7,1
488,30,0,48,9,36.0,7,2
489,1,0,74,6,32.4,4,2
489,2,0,59,7,34.1,4,3
489,3,0,99,10,33.2,8,2
489,4,0,87,8,32.7,6,2
489,5,0,89,8,33.4,4,4
489,6,0,43,5,33.3,3,2
489,7,0,48,8,34.5,5,3
489,8,0,71,8,32.0,7,1
489,9,0,88,12,33.5,8,4
489,10,0,106,14,33.7,10,4
489,11,0,85,14,32.7,10,4
489,12,0,58,7,35.9,4,3
489,13,0,65,9,34.5,6,3
489,14,0,40,7,31.3,4,3
489,15,0,62,8,42.6,6,2
489,16,0,82,13,33.7,6,7
489,17,0,68,13,33.1,9,4
489,18,0,60,9,38.6,6,3
489,19,0,62,10,34.8,7,3
489,20,0,65,13,35.6,12,1
489,21,0,50,9,33.8,5,4
489,22,0,53,9,34.7,6,3
489,23,0,90,16,31.8,11,5
489,24,0,83,15,32.7,10,5
489,25,0,56,13,36.5,8,5
489,26,0,82,15,30.9,9,6
489,27,0,67,14,32.5,6,8
489,28,0,33,9,31.3,6,3
489,29,0,62,17,34.9,10,7
489,30,0,68,16,34.0,12,4
490,1,0,66,7,37.9,4,3
490,2,0,44,5,42.3,3,2
490,3,0,42,6,40.3,5,1
490,4,0,61,7,42.8,2,5
490,5,0,72,7,40.1,3,4
490,6,0,19,4,43.2,2,2
490,7,0,33,7,41.4,2,5
490,8,0,46,4,43.9,2,2
490,9,0,50,8,39.2,6,2
490,10,0,74,9,42.0,3,6
490,11,0,58,7,39.4,6,1
490,12,0,50,7,41.2,3,4
490,13,0,43,7,40.1,3,4
490,14,0,18,3,43.6,2,1
490,15,0,68,11,51.2,4,7
490,16,0,31,5,39.5,5,0
490,17,0,97,15,41.7,8,7
490,18,0,20,3,38.4,1,2
490,19,0,54,9,42.2,5,4
490,20,0,26,7,37.7,2,5
490,21,0,34,7,40.5,2,5
490,22,0,33,5,42.3,0,5
490,23,0,91,24,41.2,14,10
490,24,0,65,12,39.2,8,4
490,25,0,54,11,41.0,6,5
490,26,0,35,9,41.3,6,3
490,27,0,35,7,42.6,4,3
490,28,0,31,5,41.0,2,3
490,29,0,47,12,41.2,5,7
490,30,0,73,15,38.1,6,9
491,1,0,133,9,77.6,4,5
491,2,0,84,7,77.3,4,3
491,3,0,95,9,77.5,3,6
491,4,0,126,12,76.3,5,7
491,5,0,120,12,76.7,5,7
491,6,0,71,7,76.4,4,3
491,7,0,67,10,79.3,6,4
491,8,0,113,13,74.8,5,8
491,9,0,121,18,79.3,9,9
491,10,0,91,11,75.1,8,3
491,11,0,97,13,75.1,6,7
491,12,0,115,14,74.4,6,8
491,13,0,77,10,76.3,7,3
491,14,0,80,13,76.2,5,8
491,15,0,115,18,74.7,9,9
491,16,0,99,14,73.9,5,9
491,17,0,115,18,73.0,13,5
491,18,0,93,15,80.3,6,9
491,19,0,116,17,73.0,9,8
491,20,0,83,13,75.8,5,8
491,21,0,80,12,75.6,4,8
491,22,0,99,18,77.0,9,9
491,23,0,121,22,74.5,13,9
491,24,0,98,17,76.8,9,8
491,25,0,107,21,76.3,8,13
491,26,0,111,22,79.2,10,12
491,27,0,79,16,78.8,8,8
491,28,0,80,15,75.9,8,7
491,29,0,106,25,78.4,14,11
491,30,0,88,17,76.5,8,9
492,1,0,86,8,76.7,3,5
492,2,0,83,6,68.2,1,5
492,3,0,46,4,71.1,1,3
492,4,0,76,7,70.3,3,4
492,5,0,66,5,71.4,1,4
492,6,0,39,5,69.6,1,4
492,7,0,37,5,70.1,1,4
492,8,0,59,8,72.2,3,5
492,9,0,63,7,72.2,2,5
492,10,0,64,10,64.4,2,8
492,11,0,78,10,69.1,4,6
492,12,0,59,8,71.5,5,3
492,13,0,55,8,69.7,2,6
492,14,0,56,8,66.9,2,6
492,15,0,94,13,72.3,7,6
492,16,0,48,8,69.9,2,6
492,17,0,74,15,70.4,4,11
492,18,0,73,13,71.6,5,8
492,19,0,97,14,72.8,7,7
492,20,0,39,9,69.4,3,6
492,21,0,47,8,71.7,5,3
492,22,0,86,19,67.8,6,13
492,23,0,48,8,71.0,4,4
492,24,0,68,13,71.4,5,8
492,25,0,57,12,74.2,3,9
492,26,0,93,18,72.8,8,10
492,27,0,54,10,67.5,4,6
492,28,0,55,12,69.9,6,6
492,29,0,76,14,68.7,6,8
492,30,0,35,8,73.5,3,5
493,1,1,91,22,70.7,15,7
493,2,1,103,24,71.3,14,10
493,3,1,118,29,73.1,20,9
493,4,1,113,31,71.3,19,12
493,5,1,70,21,71.3,12,9
493,6,1,61,20,77.7,14,6
493,7,1,65,19,71.5,11,8
493,8,1,118,37,71.0,22,15
493,9,1,129,44,71.4,18,26
493,10,1,81,29,73.0,14,15
493,11,1,85,31,69.3,11,20
493,12,1,90,33,72.2,17,16
493,13,1,72,29,71.2,18,11
493,14,1,70,29,71.7,17,12
493,15,1,92,38,72.2,17,21
493,16,1,113,49,70.6,20,29
493,17,1,91,40,73.4,18,22
493,18,1,104,45,72.5,18,27
493,19,1,111,53,75.6,27,26
493,20,1,89,43,73.5,19,24
493,21,1,71,38,74.7,18,20
493,22,1,120,60,71.7,27,33
493,23,1,104,55,69.2,29,26
493,24,1,78,43,72.9,14,29
493,25,1,97,56,68.9,36,20
493,26,1,122,68,68.9,33,35
493,27,1,54,34,73.6,15,19
493,28,1,73,42,70.6,21,21
493,29,1,118,73,71.0,30,43
493,30,1,111,69,70.1,34,35
494,1,0,22,6,49.9,2,4
494,2,0,41,3,53.4,1,2
494,3,0,29,5,52.3,1,4
494,4,0,0,5,53.6,2,3
494,5,0,53,7,52.8,1,6
494,6,0,5,5,51.8,1,4
494,7,0,23,3,50.8,2,1
494,8,0,15,2,54.8,0,2
494,9,0,0,2,52.1,2,0
494,10,0,27,4,50.6,2,2
494,11,0,30,3,50.3,0,3
494,12,0,18,6,52.2,1,5
494,13,0,5,0,50.6,0,0
494,14,0,8,2,54.9,1,1
494,15,0,21,2,55.7,0,2
494,16,0,31,5,51.9,0,5
494,17,0,0,2,45.3,0,2
494,18,0,51,7,55.6,2,5
494,19,0,22,6,51.6,2,4
494,20,0,15,5,51.5,0,5
494,21,0,24,7,50.4,2,5
494,22,0,2,1,53.7,0,1
494,23,0,24,4,50.4,2,2
494,24,0,26,6,52.6,4,2
494,25,0,0,1,52.7,0,1
494,26,0,17,3,49.3,1,2
494,27,0,6,1,50.9,0,1
494,28,0,19,5,51.7,2,3
494,29,0,7,3,52.1,2,1
494,30,0,40,9,52.5,3,6
495,1,0,18,2,77.8,1,1
495,2,0,25,3,74.8,1,2
495,3,0,5,2,74.9,2,0
495,4,0,10,6,78.0,0,6
495,5,0,32,4,78.1,1,3
495,6,0,9,3,77.6,2,1
495,7,0,6,0,77.0,0,0
495,8,0,26,3,75.3,0,3
495,9,0,6,2,75.1,1,1
495,10,0,3,0,77.7,0,0
495,11,0,21,2,77.0,1,1
495,12,0,0,4,71.4,1,3
495,13,0,8,3,77.0,1,2
495,14,0,2,2,76.2,1,1
495,15,0,26,6,74.1,4,2
495,16,0,5,1,72.2,0,1
495,17,0,38,6,76.4,3,3
495,18,0,12,1,72.7,0,1
495,19,0,39,7,75.6,3,4
495,20,0,1,1,79.6,0,1
495,21,0,19,7,79.6,4,3
495,22,0,18,5,73.9,2,3
495,23,0,18,4,77.8,1,3
495,24,0,39,9,78.6,5,4
495,25,0,0,2,73.5,0,2
495,26,0,27,5,73.7,2,3
495,27,0,0,1,75.1,0,1
495,28,0,21,6,74.6,1,5
495,29,0,5,3,74.5,1,2
495,30,0,1,3,73.7,0,3
496,1,0,9,0,38.7,0,0
496,2,0,64,6,40.4,4,2
496,3,0,5,2,40.2,1,1
496,4,0,21,4,38.1,3,1
496,5,0,36,8,42.6,7,1
496,6,0,21,5,40.7,2,3
496,7,0,5,2,41.5,1,1
496,8,0,28,5,40.2,4,1
496,9,0,45,6,38.4,3,3
496,10,0,20,4,39.2,3,1
496,11,0,1,0,42.7,0,0
496,12,0,14,4,41.5,1,3
496,13,0,20,6,42.3,5,1
496,14,0,28,5,42.2,4,1
496,15,0,49,7,46.5,3,4
496,16,0,15,3,40.5,1,2
496,17,0,33,6,40.0,3,3
496,18,0,32,4,39.0,4,0
496,19,0,14,2,39.0,0,2
496,20,0,22,3,42.9,2,1
496,21,0,15,3,42.0,2,1
496,22,0,20,5,45.3,3,2
496,23,0,43,10,37.9,5,5
496,24,0,0,1,40.5,1,0
496,25,0,23,9,40.4,8,1
496,26,0,52,12,36.4,4,8
496,27,0,20,5,39.5,2,3
496,28,0,13,6,43.8,3,3
496,29,0,14,6,41.1,2,4
496,30,0,30,8,40.7,6,2
497,1,1,70,18,64.7,10,8
497,2,1,52,11,66.2,8,3
497,3,1,49,12,66.7,5,7
497,4,1,28,8,63.7,3,5
497,5,1,74,19,65.5,12,7
497,6,1,37,10,67.4,7,3
497,7,1,49,18,67.5,8,10
497,8,1,65,22,69.8,8,14
497,9,1,71,23,68.8,11,12
497,10,1,71,24,70.8,16,8
497,11,1,53,22,67.0,11,11
497,12,1,54,20,64.2,8,12
497,13,1,54,20,66.8,7,13
497,14,1,47,18,70.6,7,11
497,15,1,48,25,65.2,18,7
497,16,1,72,32,66.8,13,19
497,17,1,51,22,68.7,15,7
497,18,1,65,28,67.8,16,12
497,19,1,45,21,65.8,6,15
497,20,1,32,18,68.4,10,8
497,21,1,43,20,70.0,8,12
497,22,1,55,31,69.0,19,12
497,23,1,52,30,68.6,11,19
497,24,1,51,31,67.2,10,21
497,25,1,75,41,65.2,23,18
497,26,1,42,22,70.1,10,12
497,27,1,51,33,65.2,23,10
497,28,1,37,22,67.2,12,10
497,29,1,74,45,64.5,23,22
497,30,1,65,41,69.1,22,19
498,1,0,77,9,79.6,2,7
498,2,0,31,3,78.6,2,1
498,3,0,88,9,84.0,3,6
498,4,0,73,8,75.5,1,7
498,5,0,88,11,78.5,3,8
498,6,0,46,7,79.8,3,4
498,7,0,45,7,79.8,1,6
498,8,0,77,9,76.8,3,6
498,9,0,79,11,80.3,3,8
498,10,0,92,12,81.0,6,6
498,11,0,74,10,78.3,4,6
498,12,0,88,12,80.0,3,9
498,13,0,55,10,77.5,5,5
498,14,0,54,7,81.6,1,6
498,15,0,69,10,75.5,4,6
498,16,0,102,15,79.6,6,9
498,17,0,69,11,77.5,0,11
498,18,0,80,13,79.1,4,9
498,19,0,74,13,79.9,3,10
498,20,0,59,10,74.9,4,6
498,21,0,29,6,80.2,3,3
498,22,0,73,12,78.1,6,6
498,23,0,82,14,83.6,8,6
498,24,0,51,8,80.0,2,6
498,25,0,49,9,79.7,5,4
498,26,0,77,16,78.9,8,8
498,27,0,36,11,77.3,4,7
498,28,0,54,10,78.5,4,6
498,29,0,87,20,80.2,10,10
498,30,0,70,16,76.5,8,8
499,1,0,57,7,79.0,4,3
499,2,0,52,4,82.1,2,2
499,3,0,28,3,80.1,1,2
499,4,0,9,1,79.0,0,1
499,5,0,9,2,81.0,1,1
499,6,0,6,4,77.7,4,0
499,7,0,26,3,77.2,2,1
499,8,0,19,4,83.3,3,1
499,9,0,24,5,79.2,4,1
499,10,0,23,5,83.3,2,3
499,11,0,31,4,82.2,3,1
499,12,0,28,5,77.5,3,2
499,13,0,26,6,76.3,4,2
499,14,0,35,6,82.6,2,4
499,15,0,50,6,74.6,2,4
499,16,0,6,1,79.6,0,1
499,17,0,29,6,79.6,5,1
499,18,0,45,6,78.4,3,3
499,19,0,14,2,77.3,0,2
499,20,0,17,4,82.0,0,4
499,21,0,28,6,82.7,2,4
499,22,0,23,6,81.6,2,4
499,23,0,48,11,83.3,5,6
499,24,0,41,8,77.0,5,3
499,25,0,59,12,82.9,6,6
499,26,0,30,6,79.2,5,1
499,27,0,20,5,76.6,1,4
499,28,0,25,5,80.7,2,3
499,29,0,36,8,83.2,3,5
499,30,0,14,4,80.7,2,2
500,1,1,70,15,41.9,11,4
500,2,1,80,22,40.1,13,9
500,3,1,79,20,46.4,15,5
500,4,1,121,30,43.4,11,19
500,5,1,113,32,43.3,12,20
500,6,1,79,23,45.0,12,11
500,7,1,74,25,41.0,11,14
500,8,1,101,33,40.0,18,15
500,9,1,98,34,40.9,22,12
500,10,1,89,32,40.2,12,20
500,11,1,81,29,41.5,15,14
500,12,1,95,35,43.8,15,20
500,13,1,76,29,42.9,11,18
500,14,1,65,27,44.6,10,17
500,15,1,100,42,38.9,21,21
500,16,1,126,52,41.0,31,21
500,17,1,76,37,40.2,16,21
500,18,1,135,59,39.6,29,30
500,19,1,101,45,41.3,28,17
500,20,1,60,33,39.7,16,17
500,21,1,73,36,41.0,23,13
500,22,1,114,58,42.5,19,39
500,23,1,104,56,39.1,34,22
500,24,1,98,52,40.4,27,25
500,25,1,96,53,42.9,31,22
500,26,1,88,50,37.4,23,27
500,27,1,66,39,40.2,18,21
500,28,1,65,39,45.0,15,24
500,29,1,114,68,41.7,33,35
500,30,1,92,55,46.6,31,24
